患者表現	出現形	標準病名
 むかつきがあってから胃の内容物を排出する現象	悪心嘔吐	悪心,嘔吐症
 血色素尿	血尿	血尿
100回以上の脈拍	頻脈	頻脈症,洞頻脈
1日尿量が100mL以下	無尿	無尿
2型糖尿病	境界型糖尿病	境界型糖尿病
30分以上続く痙攣	痙攣重積状態	痙攣重積発作
37℃台の熱	微熱	微熱
37度くらいの熱	微熱	微熱
38度以上の熱	高熱	高熱
60回未満の不整脈	徐脈	徐脈
ALPが高い血	高ＡＬＰ血症	高アルカリホスファターゼ血症
ALPの数値が高すぎる	高ＡＬＰ血症	高アルカリホスファターゼ血症
BHL	両側肺門リンパ節腫脹	両側肺門リンパ節腫脹
CAEが高い	ＣＥＡ高値	ＣＥＡ高値
CEAが高い	ＣＥＡ高値	ＣＥＡ高値
CEAの値が高い	ＣＥＡ高値	ＣＥＡ高値
CEA上昇	ＣＥＡ高値	ＣＥＡ高値
CEA値が高い	ＣＥＡ高値	ＣＥＡ高値
CH50	低補体血症	低補体血症
CKが高い血	高ＣＫ血症	高クレアチンキナーゼ血症
COPD	閉塞性換気障害,労作時呼吸苦	閉塞性換気障害,労作時呼吸困難
CPKが高い	高ＣＰＫ血症	高クレアチンキナーゼ血症
CPK値が高い症状	高ＣＰＫ血症	高クレアチンキナーゼ血症
CRC	高アミラーゼ血症,低補体血症	高アミラーゼ血症,低補体血症
GDP異常	肝機能異常	肝機能検査異常
GGO	スリガラス陰影	胸部異常陰影
Igeが高い血	高ＩｇＥ血症	高ＩｇＥ血症
JCS低下	意識レベルの低下	意識障害
LDHが高い	高LDH血症	
LDH値が高い症状	高LDH血症	
LGEという血液の成分が高め	高ＩｇＧ血症	高ＩｇＧ血症
MODS	多臓器障害	多臓器不全
SAS	無呼吸	無呼吸発作
SIRS	全身性炎症反応症候群	全身性炎症反応症候群
WPW症候群	房室回帰性頻拍	頻拍症
X 線に影が映る	スリガラス状陰影	胸部異常陰影
X線で肺に影が映る	肺浸潤影	肺部異常陰影
coma	意識混濁	意識混濁
cpkが高い	高ＣＰＫ血症	高クレアチンキナーゼ血症
fever	発熱	発熱
wheezing	喘鳴	喘鳴
ytr	記銘力障害	記銘力低下,記憶障害
Ⅰ型糖尿病ともⅡ型糖尿病とも区別つかない	境界型糖尿病	境界型糖尿病
あおあざ	皮下出血,チアノーゼ	皮下出血,チアノーゼ
あおじ	圧痕浮腫,皮下出血斑	浮腫,皮下出血
あおたん	皮下出血,皮下出血斑,出血斑	皮下出血,斑状出血
あおぢ	皮下出血	皮下出血
あかくなった	発赤	発赤
あかくはれた	発赤腫脹	発赤
あかくはれてる	発赤腫脹	発赤
あかくはれる	粘膜発赤	発赤
あかしん	紅色丘疹	紅色丘疹
あかみ	紅色丘疹	紅色丘疹
あく	浮腫	浮腫
あくしん	悪心	悪心
あげそうな感じ	上腹部不快感	腹部不快感
あげる	嘔吐	嘔吐症
あさ	皮下結節　	
あざ	出血斑,皮下出血斑,点状出血,圧痕浮腫,皮下出血,黄疸	斑状出血,皮下出血,点状出血,浮腫,黄疸
あざになる	皮下出血	皮下出血
あしいた	下肢疼痛	疼痛
あしいたい	下肢疼痛	疼痛
あしうずい	下肢脱力感	下肢脱力感
あしがぐったり	下肢脱力感	下肢脱力感
あしがみだれる	ふらつき	めまい
あしがむくんでる	下腿浮腫	下腿浮腫
あしのいたみ	下肢疼痛	疼痛
あじおんち	味覚障害	味覚障害
あせかき	発汗過多	多汗症
あせだぐ	発汗過多	多汗症
あせっかき	発汗過多	多汗症
あせをおおくかく	発汗過多	多汗症
あぜん	失語症	失語症
あそこから血	性器出血	性器出血
あたまいた	拍動性頭痛,後頭部痛,頭痛,頭部痛	頭痛,後頭部痛
あたまいたい	後頭部痛	後頭部痛
あたまいわす	頭重感	頭重感
あたまがいたい	頭痛	頭痛
あたまがおもいがんじ	頭重感	頭重感
あたまがおもくかんじる	頭重感	頭重感
あたまが痛い	拍動性頭痛	頭痛
あたまが重い感じ	頭重感	頭重感
あだまいでえ	頭痛	頭痛
あちこちのリンパは腫れる	多発リンパ節腫大	リンパ節腫大
あっこんされる	圧痕性浮腫	浮腫
あっぱく	前胸部圧迫感	胸部不快感
あっぱくかん	前胸部圧迫感	胸部不快感
あつい	熱感	ほてり
あついた	温痛	温痛覚過敏
あつい痛い	温痛	温痛覚過敏
あつぽい	熱感	ほてり
あづ	熱	発熱
あづい	高熱,発熱	高熱,発熱
あまり食べたくない	食欲低下	食欲不振
あるがんね	歩行困難	歩行困難
あるくことがふじゆう	歩行困難	歩行困難
あるけん	歩行障害,歩行困難	歩行障害,歩行困難
あるげね	歩行障害	歩行障害
あるはずの無いものが感じられる	幻覚	幻覚
あんし	嘔気嘔吐	嘔気,嘔吐症
あんまりでない	乏尿	乏尿
いがいたい	胃部不快感	腹部不快感
いきがくるしい	呼吸苦,呼吸困難	呼吸促迫,呼吸困難,呼吸困難
いきがくるしいとかんじる	呼吸困難感	呼吸麻痺
いきがとまってる	呼吸停止	呼吸停止
いきがとまる	呼吸停止	呼吸停止
いきぎれ	動悸,労作時呼吸苦,労作時息切れ	動悸,労作時呼吸困難,息切れ
いきなり死亡する	突然死	突然死
いきをするのがつらい	拘束性換気障害	拘束性換気障害
いぎぐるすい	呼吸苦	呼吸促迫,呼吸困難
いくつかの臓器が悪くなる	多臓器不全	多臓器不全
いくつかの臓器の調子が悪い	多臓器障害	多臓器不全
いしきがなくなる	意識レベル低下	意識障害
いしきがはっきりしない	意識レベルの低下	意識障害
いしきぼうぜん	意識混濁	意識混濁
いしきをうしなった	意識障害	意識障害
いしとはかんけいなくこまかくふるえること	振戦	振戦
いしゃ	表在リンパ節腫脹	リンパ節腫大
いたい	温痛,圧痛,痛み,左前胸部痛	温痛覚過敏,圧痛,疼痛,前胸部痛
いたみ	疼痛,癌性疼痛,左側胸部痛,全身痛	疼痛,癌性疼痛,側胸部痛,全身痛
いちびり	異常感覚	異常触覚,異常知覚
いっっかい	一過性意識障害	一過性意識障害
いっぱい水分とっていっぱいおしっこすること	多飲多尿	多飲症,多尿
いっぱい飲むといっぱい尿が出る	多飲多尿	多飲症,多尿
いつもとは違った感じ	異常感覚	異常触覚,異常知覚
いつもまんぷくとかんじる	腹満感	腹部膨満
いつも咳が出る	慢性咳嗽	慢性咳嗽
いでえ	痛み,激痛	疼痛
いぼ	丘疹,硬結,固縮	丘疹,硬結,こわばり
いもたれ	胃部不快感	腹部不快感
いもてれ	胃部不快感	腹部不快感
いろいろなことがわからなくなる	見当識障害	見当識障害
いろのこいおしっこ	褐色尿	ビリルビン尿
いろんなところのリンパが腫れる	多発リンパ節腫大	リンパ節腫大
いんえい	スリガラス様陰影	胸部異常陰影
いんりょうかた	多飲	多飲症
うき	むくみ	浮腫
うきろくぶつう	右季肋部痛	季肋部痛
うずく	疼痛	疼痛
うずくような痛みのこと	疼痛	疼痛
うちみ	圧痕浮腫,皮下出血斑,圧痛	浮腫,皮下出血,圧痛
うっ血	発赤	発赤
うつ	易疲労感	易疲労感
うつ状態	昏迷	昏迷
うつ病	昏迷,易疲労感	昏迷,易疲労感
うづく	疼痛	疼痛
うなじが固まる	項部硬直	項部硬直
うなじ硬直	項部硬直	項部硬直
うまくしゃべれない	構語障害,呂律困難	構語障害,構音障害
うまく喋れへん	構音障害	構音障害
うまく歩けない	歩行障害	歩行障害
うまく発音できない	構音障害	構音障害
うまく言葉を口に出して言えない	構語障害	構語障害
うまく話せない	運動性失語,呂律困難,呂律不良	運動性失語症,構音障害,不明瞭言語
うまく食べ物を飲み込めない	嚥下困難	嚥下困難
うまく飲み込めない	嚥下困難,嚥下困難感,嚥下機能障害,嚥下障害	嚥下困難,嚥下協調障害,嚥下障害,嚥下障害
うまく飲み込めないこと	嚥下困難感	嚥下困難
うみ	腫瘤,浮腫	腫瘤,浮腫
うめぐねえ	味覚障害	味覚障害
うわっタンに血混じっとる	血痰	血痰
うんこが黒い	黒色便	黒色便
うんこの色が黒い	黒色便	黒色便
えし	乾酪壊死	壊死
えずく	吐き気	嘔気
えづいて吐く	嘔気嘔吐	嘔気,嘔吐症
えでぃま	ｐｉｔｔｉｎｇ　ｅｄｅｍａ	浮腫
えでま	浮腫状変化,粘膜浮腫,左下肢腫脹,圧痕性浮腫	浮腫,下肢腫脹
えらい	易疲労感,疲労感,脱力感	易疲労感,疲労感,脱力感
えらいねつ	高熱	高熱
えんがい	咳	咳
えんげにしょうがいがある	嚥下障害	嚥下障害
えー	嘔吐	嘔吐症
おうけ	吐気,吐き気	嘔気
おうせん	皮膚黄染	黄疸
おうせんいじょう	黄染	黄疸
おうだん	黄染,皮膚黄染,高ビリルビン血症	黄疸,高ビリルビン血症
おうとするじょうたい	吐き気	嘔気
おえつ	喘鳴	喘鳴
おえりそう	嘔気	嘔気
おえる	嘔吐	嘔吐症
おおきい腫瘤	巨大腫瘤	腫瘤
おおきなしゅよう	巨大腫瘤	腫瘤
おおくのむとにょうがおおくでる	多飲多尿	多飲症,多尿
おおのみ	多飲	多飲症
おかしいところ	痛み	疼痛
おかしい感じ方	異常感覚	異常触覚,異常知覚
おかしな行動	異常行動	異常行動
おかしな行動をとる	異常行動	異常行動
おかしな行動を取る	異常行動	異常行動
おしっこおわる	尿閉	尿閉
おしっこがあまり出ない	乏尿	乏尿
おしっこがいっぱい出る	多尿	多尿
おしっこがおおい	多尿	多尿
おしっこがたまらない状態	無尿状態	無尿
おしっこができない	排尿困難	排尿困難
おしっこがでない	無尿,無尿状態,排尿困難	無尿,排尿困難
おしっこがでにくい	排尿障害	排尿障害
おしっこがひんぱん	頻尿	多尿,頻尿症
おしっこがよく出る	頻尿	多尿,頻尿症
おしっこが余りでない	乏尿	乏尿
おしっこが全く出ない	無尿	無尿
おしっこが出しにくい	排尿困難	排尿困難
おしっこが出すぎる	多尿	多尿
おしっこが出づらい	排尿困難	排尿困難
おしっこが出ない	無尿状態,無尿,排尿困難,尿閉,排尿障害,乏尿	無尿,排尿困難,尿閉,排尿障害,乏尿
おしっこが出ないや出が悪い	排尿障害	排尿障害
おしっこが出にくい	排尿障害,排尿困難,尿閉	排尿障害,排尿困難,尿閉
おしっこが変	蛋白尿	蛋白尿
おしっこが多い	多尿,多飲多尿	多尿,多飲症,多尿
おしっこが少ない	乏尿	乏尿
おしっこが少なすぎる	乏尿	乏尿
おしっこが泡立つ	蛋白尿	蛋白尿
おしっこが濃い	褐色尿	ビリルビン尿
おしっこが痛い	排尿時痛	排尿痛
おしっこが茶色い	褐色尿	ビリルビン尿
おしっこが赤い	肉眼的血尿	肉眼的血尿
おしっこが赤いとはっきり分かる	肉眼的血尿	肉眼的血尿
おしっこが近い	頻尿,多飲多尿,多尿	多尿,頻尿症,多飲症,多尿,多尿
おしっこが近いこと	頻尿	多尿,頻尿症
おしっこしたとき痛い	排尿時痛	排尿痛
おしっこしにくい	排尿困難	排尿困難
おしっこすることがむずかしい	排尿困難	排尿困難
おしっこするときに痛みが走る	排尿時痛	排尿痛
おしっこするとき痛い	排尿時痛	排尿痛
おしっこすると痛い	排尿時痛	排尿痛
おしっこするのが難しい	排尿困難	排尿困難
おしっこする時に痛い	排尿時痛	排尿痛
おしっこでない	無尿	無尿
おしっこにすぐに行きたくなる	頻尿	多尿,頻尿症
おしっこにたんぱく混じってる	尿蛋白	蛋白尿
おしっこにタンパクが出た	高度蛋白尿	蛋白尿
おしっこにタンパクが多く残る	蛋白尿	蛋白尿
おしっこに時間がかかる	排尿障害	排尿障害
おしっこに血が出る	尿潜血	顕微鏡的血尿
おしっこに血が混ざる	血尿	血尿
おしっこに血が混じった	血尿	血尿
おしっこに血が混じっている	尿潜血,血尿	顕微鏡的血尿,血尿
おしっこに血が混じってる	肉眼的血尿	肉眼的血尿
おしっこに血が混じる	尿潜血,血尿,肉眼的血尿	顕微鏡的血尿,血尿,肉眼的血尿
おしっこに血のようなものが混ざっている	尿潜血	顕微鏡的血尿
おしっこに高いたんぱく混じってる	高度蛋白尿	蛋白尿
おしっこのとき痛い	排尿時痛	排尿痛
おしっこの出が悪い	排尿障害	排尿障害
おしっこの回数が多い	頻尿	多尿,頻尿症
おしっこの時に痛みを感じる	排尿時痛	排尿痛
おしっこの色がおかしい	褐色尿	ビリルビン尿
おしっこの色が濃い	褐色尿	ビリルビン尿
おしっこの色が茶色っぽい	褐色尿	ビリルビン尿
おしっこの色が褐色	褐色尿	ビリルビン尿
おしっこの量が多い	多尿	多尿
おしっこの量が少ないこと	乏尿	乏尿
おしっこの量が減る	乏尿	乏尿
おしっこをすると痛い	排尿時痛	排尿痛
おしっこをする時の痛み	排尿時痛	排尿痛
おしっこを外に出せなくなる	排尿障害	排尿障害
おしっこ出ない	無尿状態	無尿
おしっこ出にくい	排尿障害	排尿障害
おしっこ出るとこが血で詰まる	尿潜血	顕微鏡的血尿
おしっこ出過ぎ	夜間頻尿	夜間頻尿症
おしっこ異常	尿蛋白	蛋白尿
おしりにいぼ	労作時息切れ	息切れ
おすと痛い	圧痛	圧痛
おたふく	耳下腺腫脹	耳下腺腫脹
おたふくかぜ	耳下腺腫脹,腹部リンパ節腫大	耳下腺腫脹,リンパ節腫大
おたふく風邪	耳下腺腫脹	耳下腺腫脹
おちる	意識消失	意識消失
おっしこが赤い	血尿	血尿
おっつ	運動性失語	運動性失語症
おでき	腫瘍性病変,粒状陰影,腫瘤,嚢胞内出血,腫大リンパ節,圧痕性浮腫,巨大腫瘤,紅色丘疹,皮疹,発疹,浮腫	-1,胸部異常陰影,腫瘤,内出血,リンパ節腫大,浮腫,紅色丘疹,発疹
おでこで水が沸ける	高熱	高熱
おとが、きこえずらい	構音障害	構音障害
おとなしくしてる時に胸が痛い	安静時胸痛	反復性胸痛,胸痛
おとなしくしてる時息するの難しい	安静時呼吸困難	呼吸困難
おなかいた	腹部痛,右下腹部痛,左下腹部痛,右側腹部痛,上腹部痛	腹痛症,下腹痛,腸仙痛,下腹痛,臍下部痛,側腹部痛,上腹部痛
おなかいっぱい	腹部膨満,腹部膨満感	腹部膨満
おなかがいたい	腹部痛,腹痛発作	腹痛症
おなかがいっぱい	腹満	腹部膨満
おなかがおかしい	腹部違和感	腹部不快感
おなかがすかない	食欲不振,腹部膨満感	食欲不振,腹部膨満
おなかがはっている	腹満感	腹部膨満
おなかがふくれているかんじがする	腹部膨満感	腹部膨満
おなかがふくれる	腹部膨隆	腹部膨満
おなかがへらない	食思不振	食欲不振
おなかが一杯	腹部膨満	腹部膨満
おなかが変な感じ	腹部不快感,腹部違和感	腹部不快感
おなかが張っているような感じ	腹満感	腹部膨満
おなかが張る	腹部膨満感,腹部膨満	腹部膨満
おなかが減りにくい	食欲低下	食欲不振
おなかが痛い	腹痛,腹痛発作,上腹部不快感	腹痛症,腹壁痛,仙痛,腹痛症,腹部不快感
おなかが膨れる	膨満	腹部膨満
おなかにたまった水に血が含まれている	血性腹水	血性腹水
おなかにペットボトルを2本も抱えたような居心地の悪さ	腹水貯留	腹水症
おなかに水がたまる	腹水貯留,大量腹水	腹水症
おなかに水が溜まってなかなか治らない	難治性腹水	難治性腹水
おなかに違和感がある	腹部不快感	腹部不快感
おなかのしこり	腹部腫瘤	腹部腫瘤
おなかのできもの	腹腔内腫瘤	腹腔内腫瘤
おなかのはり	腹部膨満感	腹部膨満
おなかのハリ	腹部膨満感,腹部膨満	腹部膨満
おなかの上がいたい	上腹部痛	上腹部痛
おなかの中のこぶ	腹腔内腫瘤	腹腔内腫瘤
おなかの具合が悪い	腹痛発作	腹痛症
おなかの右上が痛い	右上腹部痛	上腹部痛
おなかの部分が盛り上がる	腹部膨隆	腹部膨満
おなか痛	左側腹部痛	側腹部痛
おなら	高炭酸ガス血症	高炭酸ガス血症
おねしょ	無尿,夜間頻尿	無尿,夜間頻尿症
おねつ	微熱,発熱	微熱,発熱
おほおほ	咳	咳
おぼえることができない	記憶障害	記憶障害
おむつが必要になった	排尿障害	排尿障害
おもい	倦怠感	倦怠感
おもぐるしい痛み	鈍痛	鈍痛
おもてにあるりいぱせつがはれる	表在リンパ節腫脹	リンパ節腫大
おもらし	排尿困難	排尿困難
おんつう	温痛覚障害,温痛	温痛覚過敏
お漏らし	夜間頻尿	夜間頻尿症
お灸	丘疹	丘疹
お熱	熱,発熱	発熱
お腹いた	腹部痛,左側腹部痛,腹痛	腹痛症,側腹部痛,腹痛症,腹壁痛,仙痛
お腹いっぱい	腹満感,腹部膨満感,腹満,膨満	腹部膨満
お腹がいたい	腹部痛,腹痛	腹痛症,腹痛症,腹壁痛,仙痛
お腹がいっぱい	腹満感,腹部膨満感	腹部膨満
お腹がいっぱいの感じ	腹部膨満	腹部膨満
お腹がいっぱいの感じがする	腹満感	腹部膨満
お腹がきつい	腹満,膨満	腹部膨満
お腹がすかない	食欲不振,食欲低下	食欲不振
お腹がなんとなく気持ち悪い	腹部不快感	腹部不快感
お腹がはってる	腹部膨満感,腹水	腹部膨満,腹水症
お腹がはる	腹部膨満感,腹水,腹満感,腹水貯留,腹部膨満	腹部膨満,腹水症
お腹がふくれる	腹満,膨満	腹部膨満
お腹がむかむかする	腹部不快感	腹部不快感
お腹がチクチクする	腹痛	腹痛症,腹壁痛,仙痛
お腹がパンパン	腹満感	腹部膨満
お腹がムカムカする	上腹部不快感	腹部不快感
お腹がモヤモヤする	腹部不快感	腹部不快感
お腹が出ている	腹部膨隆	腹部膨満
お腹が変	腹部違和感,難治性腹水	腹部不快感,難治性腹水
お腹が張った感じ	腹満感	腹部膨満
お腹が張っている	腹満感,腹部膨満感,腹満,膨満	腹部膨満
お腹が張っている感じ	腹部膨満感	腹部膨満
お腹が張ってる	腹部膨満	腹部膨満
お腹が張って苦しい	腹部膨満,腹部膨満感	腹部膨満
お腹が張る	腹部膨満感,腹部膨満,膨満,腹満,腹満感,腹部腫瘤,腹水	腹部膨満,腹部腫瘤,腹水症
お腹が張ること	腹満	腹部膨満
お腹が張る感じ	腹満感	腹部膨満
お腹が気持ち悪い	腹部不快感,腹部違和感,胃部不快感	腹部不快感
お腹が減らない	食思不振	食欲不振
お腹が痛い	腹痛,腹部痛,下腹部痛,腹痛発作,上腹部痛,左季肋部痛,右上腹部痛,左下腹部痛,腹部不快感	腹痛症,腹壁痛,仙痛,腹痛症,下腹痛,上腹部痛,季肋部痛,下腹痛,臍下部痛,腹部不快感
お腹が痛いこと	腹痛	腹痛症,腹壁痛,仙痛
お腹が痛くなる	腹痛発作	腹痛症
お腹が痛くなること	腹痛発作	腹痛症
お腹が痛む	腹痛	腹痛症,腹壁痛,仙痛
お腹が硬くなる	筋性防御	筋性防御
お腹が脹れる	腹部膨満感	腹部膨満
お腹が腫れる	腹部膨満	腹部膨満
お腹が膨らむ	腹部膨満,腹部膨隆	腹部膨満
お腹が膨らむ感じがする	腹満感	腹部膨満
お腹が膨らんで	腹満	腹部膨満
お腹が膨れた感じ	腹部膨満感	腹部膨満
お腹が膨れた感じがする	腹部膨満感	腹部膨満
お腹が膨れた感じがする症状	腹満	腹部膨満
お腹が膨れた感覚	腹部膨満感	腹部膨満
お腹が膨れている	腹満,腹部膨満感	腹部膨満
お腹が膨れて苦しい	腹部膨満,腹部膨満感	腹部膨満
お腹が膨れる	腹部膨満,腹部膨隆,膨満,腹部膨満感	腹部膨満
お腹が膨れ上がる	腹部膨隆	腹部膨満
お腹が重い	腹部痛,腹部不快感	腹痛症,腹部不快感
お腹すかない	食思不振	食欲不振
お腹にこぶができている	腹腔内腫瘤	腹腔内腫瘤
お腹にたまった水	腹水	腹水症
お腹にたまった水に血が混じっている	血性腹水	血性腹水
お腹にたまる水	腹水	腹水症
お腹にできもの	腹部腫瘤	腹部腫瘤
お腹にガスがたまる	腹部膨満	腹部膨満
お腹にガスがたまる感覚	腹部膨満感	腹部膨満
お腹に出来たできもの	腹部腫瘤	腹部腫瘤
お腹に変な感じ	腹部不快感	腹部不快感
お腹に水	腹水	腹水症
お腹に水がたまった	腹水	腹水症
お腹に水がたまる	腹水,腹水貯留,大量腹水,難治性腹水,血性腹水	腹水症,難治性腹水,血性腹水
お腹に水がたまること	腹水	腹水症
お腹に水が溜まってる	腹水貯留	腹水症
お腹に水が溜まりやすい	難治性腹水	難治性腹水
お腹に水が溜まる	腹水貯留	腹水症
お腹に水が貯まる	腹水	腹水症
お腹に溜まった水	腹水	腹水症
お腹に瘤がある	腹部腫瘤	腹部腫瘤
お腹に瘤状の出来物	腹部腫瘤	腹部腫瘤
お腹に血がたまる	血性腹水	血性腹水
お腹に血が混じった水がたまる	血性腹水	血性腹水
お腹に血状の水分が溜まる	血性腹水	血性腹水
お腹に違和感	腹部不快感	腹部不快感
お腹に違和感がある	腹部不快感,腹部違和感	腹部不快感
お腹のあたりが気持ち悪い	腹部不快感	腹部不快感
お腹のあたりが気持ち悪い症状	腹部不快感	腹部不快感
お腹のしこり	腹腔内腫瘤	腹腔内腫瘤
お腹のなかのリンパ節が腫れる	腹腔内リンパ節腫脹	リンパ節腫大
お腹のはり	腹部膨満感	腹部膨満
お腹のリンパが腫れた	腹腔内リンパ節腫大	リンパ節腫大
お腹のリンパが腫れていること	腹腔内リンパ節腫大	リンパ節腫大
お腹のリンパが腫れる	腹腔内リンパ節腫脹,腹部リンパ節腫大,腹腔内リンパ節腫大	リンパ節腫大
お腹のリンパのガン	腹部リンパ節腫大	リンパ節腫大
お腹のリンパ節がはれる	腹部リンパ節腫大	リンパ節腫大
お腹のリンパ節が腫れていること	腹腔内リンパ節腫脹	リンパ節腫大
お腹の上が痛い	上腹部痛	上腹部痛
お腹の上の方が痛い	上腹部痛	上腹部痛
お腹の上の部分が痛い	上腹部痛	上腹部痛
お腹の上側が気持ち悪い	上腹部不快感	腹部不快感
お腹の上辺りが気持ち悪い感じ	上腹部不快感	腹部不快感
お腹の上部が痛い	上腹部痛	上腹部痛
お腹の上部で違和感がある	上腹部不快感	腹部不快感
お腹の上部の痛み	上腹部痛	上腹部痛
お腹の下が痛い	下腹部痛	下腹痛
お腹の下の方が痛い	下腹部痛	下腹痛
お腹の中に腫瘍ができる	腹腔内腫瘤	腹腔内腫瘤
お腹の中のリンパ節が腫れる	腹腔内リンパ節腫大	リンパ節腫大
お腹の中の腫瘍	腹腔内腫瘤	腹腔内腫瘤
お腹の右が痛い	右下腹部痛,右側腹部痛	下腹痛,腸仙痛,側腹部痛
お腹の右の上が痛い	右上腹部痛	上腹部痛
お腹の右上あたりが痛い	右上腹部痛	上腹部痛
お腹の右上が痛い	右上腹部痛	上腹部痛
お腹の右上の痛み	右上腹部痛	上腹部痛
お腹の右下が痛い	右下腹部痛	下腹痛,腸仙痛
お腹の右下の痛み	右下腹部痛	下腹痛,腸仙痛
お腹の右下側が痛い	右下腹部痛	下腹痛,腸仙痛
お腹の右側が痛い	右側腹部痛	側腹部痛
お腹の右側の痛み	右側腹部痛	側腹部痛
お腹の左が痛い	左下腹部痛,左側腹部痛	下腹痛,臍下部痛,側腹部痛
お腹の左上が痛む	左上腹部痛	上腹部痛
お腹の左下が痛い	左下腹部痛	下腹痛,臍下部痛
お腹の左下側が痛い	左下腹部痛	下腹痛,臍下部痛
お腹の張り	腹部膨満感,腹満,腹部腫瘤,腹部不快感,腹部膨満	腹部膨満,腹部腫瘤,腹部不快感
お腹の横が痛い	側腹部痛	側腹部痛
お腹の発作	腹痛発作	腹痛症
お腹の腫瘤	腹部腫瘤	腹部腫瘤
お腹の調子が悪い	腹部違和感	腹部不快感
お腹の違和感	腹部違和感,腹部不快感	腹部不快感
お腹右上部の痛み	右上腹部痛	上腹部痛
お腹減らない	食思不振,食欲不振	食欲不振
お腹痛	腹痛	腹痛症,腹壁痛,仙痛
お腹痛い	腹痛,腹痛発作	腹痛症,腹壁痛,仙痛,腹痛症
お腹空かない	食欲不振,食欲低下	食欲不振
お腹部分の違和感	腹部違和感	腹部不快感
かいかい	皮疹	発疹
かおいろがわるい	顔色不良	顔面蒼白
かおいろふりょう	顔色不良	顔面蒼白
かおいろわる	顔色不良	顔面蒼白
かおいろわるい	顔色不良	顔面蒼白
かげ	肺陰影,線状影	胸部異常陰影
かげがくもりガラス状にみえる	スリガラス状陰影	胸部異常陰影
かげってる	スリガラス陰影	胸部異常陰影
かこきゅう	頻呼吸	頻呼吸
かさぶた	痂皮,落屑,出血斑	痂皮,鱗屑,斑状出血
かさぶたがおおきくなった	腫大	リンパ節腫大
かさぶたの変化	浮腫性変化	浮腫
かしむくみ	下肢浮腫	下肢浮腫
かじん	味覚異常	味覚異常
かすれ声	嗄声	嗄声
かぜ	熱	発熱
かぜ、風邪	発熱	発熱
かたくなる	こわばり	こわばり
かたまりのこと	ｍａｓｓ	腫瘤
かたまる	こわばり	こわばり
かっしょくのションベン	褐色尿	ビリルビン尿
かったりい	倦怠感	倦怠感
かったるい	全身倦怠感,倦怠感	全身倦怠感,倦怠感
かっ血	血痰	血痰
かどう	寡動	行動緩慢
かなしばり	痙攣重積状態	痙攣重積発作
かひ	痂皮	痂皮
かぶれ	痂皮,皮疹,発疹,発赤	痂皮,発疹,発赤
かぶれる	発疹	発疹
かゆい	皮疹,疼痛	発疹,疼痛
かゆみ	丘疹,皮疹	丘疹,発疹
かゆみのある場所	皮疹	発疹
からからせき	乾性咳	乾性咳
からせき	乾性咳	乾性咳
からぜき	乾性咳	乾性咳
からだがしびれて動きにくい	しびれ感	しびれ感
からだがだるい	全身倦怠感	全身倦怠感
からだのむくみ	全身性浮腫	全身性浮腫
からだの先端が腐る	壊死	壊死
から咳	乾性咳嗽,乾性咳	乾性咳
かわいたせき	乾性咳嗽	乾性咳
かわいた咳	乾性咳	乾性咳
かわき	口渇感	口渇症
かわしたしゅっけつはん	皮下出血斑	皮下出血
かわむけ	落屑	鱗屑
かんかくがかびん	温痛覚低下	知覚鈍麻
かんきがおかしい	拘束性換気障害	拘束性換気障害
かんせん	黄染	黄疸
か呼吸	頻呼吸	頻呼吸
がすだまり	腹部膨満感	腹部膨満
がたがた震える	強直性痙攣	強直性痙攣
がまんできない腹痛	急性腹症	急性腹症
がらがらごえ	嗄声	嗄声
がり	体重減少	体重減少
がん	腫瘍性病変,腹腔内腫瘤,巨大腫瘤,ＣＥＡ高値,肺門リンパ節腫大,嚢胞性腫瘤,多発リンパ節腫脹,脾腫,頚部腫瘤,頚部リンパ節腫脹,肝脾腫,リンパ節腫大	-1,腹腔内腫瘤,腫瘤,ＣＥＡ高値,肺門リンパ節腫脹,リンパ節腫大,脾腫,頚部腫瘤,頚部リンパ節腫脹,肝脾腫
がんがん	頭痛	頭痛
がんの痛み	癌性疼痛	癌性疼痛
がん性痛	癌性疼痛	癌性疼痛
がん腫瘍	リンパ節腫大	リンパ節腫大
きおくがおかしい	記銘力障害	記銘力低下,記憶障害
きおくがおかしくなる	記銘力障害	記銘力低下,記憶障害
きおくしょうがい	物忘れ	健忘症
きちがい	意識障害	意識障害
きちんと循環しない	循環不全	急性循環不全,末梢循環不全
きちんと歩けない	歩行困難	歩行困難
きつおんしょうがい	構音障害	構音障害
きつぎゃく	吃逆	横隔膜痙攣症,しゃっくり
きのうしょうがい	嚥下機能障害	嚥下協調障害,嚥下障害
きもい	吐き気	嘔気
きもちが悪い	嘔気	嘔気
きゅうしん	丘疹	丘疹
きょうく	胸苦	胸部不快感
きょうすい	膵性胸水	胸水検査異常
きょうつう	心窩部痛	心窩部痛
きょうつぶう	左前胸部痛	前胸部痛
きょうふつ	左側胸部痛	側胸部痛
きょうぶえいいじょう	胸部異常影	胸部異常陰影
きょうぶがいたい	胸痛	胸痛
きょうぶつう	左胸部痛	胸痛
きょだつ	虚脱	虚脱
きりきりする	腹痛	腹痛症,腹壁痛,仙痛
きをうしなう	失神発作	失神
くいだぐね	食欲不振,摂食不良	食欲不振,摂食機能障害
くうどうかげ	空洞影	胸部異常陰影
くされ	壊死	壊死
くしゅん	咳	咳
くだす	腹痛発作	腹痛症
くちがかわく	口渇	口渇症
くちのかわき	口渇感	口渇症
くっつい	腹満	腹部膨満
くびがはれる	頚部腫脹	頚部腫脹
くびのはれ	頚部腫脹	頚部腫脹
くびのりんぱせんがはれた。	頚部リンパ節腫脹	頚部リンパ節腫脹
くも	肺結節影	肺部異常陰影
くも膜下出血	再出血	出血
くらくら	めまい感	めまい感
くらくらする	めまい,眩暈,めまい感,浮動性めまい,ふらつき,意識障害	めまい,めまい感,意識障害
くらくらするさま	眩暈	めまい
くらくらする感じ	めまい感	めまい感
くらっくる	ｆｉｎｅ　ｃｒａｃｋｌｅｓ	湿性ラ音
くらっとする	めまい,眩暈	めまい
くらつき	ふらつき	めまい
くらみ	眩暈,めまい	めまい
くらむ	めまい感	めまい感
くるしい	拘束性換気障害,胸苦	拘束性換気障害,胸部不快感
くるしい息切れなど	動悸発作	動悸
くるしくなった	労作時呼吸困難	労作時呼吸困難
くるすい	呼吸困難	呼吸困難
くるっとる	異常行動	異常行動
くろいうんこ	黒色便	黒色便
くろくみえる	眼前暗黒感	眼前暗黒
ぐいだぐねんだ	食欲低下	食欲不振
ぐったり	脱力,脱力感,虚脱	脱力感,筋脱力,脱力感,虚脱
ぐったりする	脱力感	脱力感
ぐらぐらする	めまい	めまい
ぐらづぐ	めまい感	めまい感
ぐるぐる	めまい,めまい感	めまい,めまい感
ぐるぐるする	めまい	めまい
ぐるぐる回る	めまい	めまい
けいひろうかん	易疲労感	易疲労感
けいれん	けいれん発作,痙攣発作,強直性痙攣,全身性痙攣,痙攣重積状態,不随意運動,しびれ	てんかん様発作,痙攣発作,痙攣重積発作,全身痙攣発作,痙攣発作,強直性痙攣,全身痙攣,痙攣重積発作,不随意運動症,しびれ感
けいれんが急に起こる	けいれん発作	てんかん様発作,痙攣発作,痙攣重積発作,全身痙攣発作
けいれんする発作	けいれん発作	てんかん様発作,痙攣発作,痙攣重積発作,全身痙攣発作
けいれんの発作	痙攣発作	痙攣発作
けだるい	疲労感,四肢脱力,脱力感	疲労感,四肢脱力,脱力感
けっかんでふせいみゃくをしる	血管雑音	動脈性雑音
けっしょう	高乳酸血症,高ＩｇＧ血症,高ＩｇＥ血症	高乳酸血症,高ＩｇＧ血症,高ＩｇＥ血症
けっせつ	硬結	硬結
けっとうちがたかい	高血糖	高血糖症
けつえきがまざったたん	血痰	血痰
げいぶ	頚部腫瘤	頚部腫瘤
げっぷ	吃逆,心窩部不快感	横隔膜痙攣症,しゃっくり,心窩部不快
げつう	嚥下痛	嚥下痛
げほ	咳	咳
げほげほした咳	湿性咳嗽	湿性咳,慢性咳嗽
げぼ	嘔吐	嘔吐症
げぼる	嘔吐	嘔吐症
げろ	嘔吐,吐き気,嘔気	嘔吐症,嘔気
げろいた	嚥下痛	嚥下痛
げろっぱ	吐気	嘔気
げろはいだ	嘔吐	嘔吐症
げー	嘔吐	嘔吐症
こうCKに血が出てる	高ＣＫ血症	高クレアチンキナーゼ血症
こういがくしけっしょう	高ＩｇＧ４血症	ＩｇＧ４関連疾患,高ＩｇＧ血症
こういちけっしょう	高ＩｇＧ血症,高ＩｇＧ４血症	高ＩｇＧ血症,ＩｇＧ４関連疾患,高ＩｇＧ血症
こういジーヨンけっしょう	高ＩｇＧ４血症	ＩｇＧ４関連疾患,高ＩｇＧ血症
こうきゅう	紅色丘疹	紅色丘疹
こうぐん	全身性炎症反応症候群	全身性炎症反応症候群
こうけつ	硬結	硬結
こうけつあつ	高ＩｇＧ血症	高ＩｇＧ血症
こう血	喀血	喀血
こえた	体重増加	体重増加
こきゅうがはげしくなる	頻呼吸	頻呼吸
こきゅうこんなん	労作性呼吸困難	発作性呼吸困難,労作時呼吸困難
こころわるい	悪心嘔吐,腹部不快感,吐き気	悪心,嘔吐症,腹部不快感,嘔気
こしゃく	固縮	こわばり
ことばがでない	構語障害	構語障害
こぶ	腫瘤,皮下腫瘤,腫瘤形成,腫瘍性病変,多発腫瘤,腫瘤像,巨大腫瘤,腹部腫瘤,腫大	腫瘤,皮下腫瘤,-1,腹部腫瘤,リンパ節腫大
こぶができた	皮下腫瘤	皮下腫瘤
こぶが多く発生する	多発性腫瘤	腫瘤
こぶのようなできもの	ｍａｓｓ	腫瘤
こり	頚部腫瘤	頚部腫瘤
こわい	疲労感	疲労感
こわばり	硬結,固縮	硬結,こわばり
こわばる	固縮,こわばり	こわばり
こんこん	乾性咳嗽	乾性咳
こんなん	嚥下困難感,労作性呼吸困難	嚥下困難,発作性呼吸困難,労作時呼吸困難
ごく些細な血尿のこと	顕微鏡的血尿	顕微鏡的血尿
ごほごほ	咳	咳
ごろごろする	喘鳴	喘鳴
ご飯の後に血糖値が上がる	食後高血糖	高血糖症
ご飯の後の高血糖	食後高血糖	高血糖症
さいぼうがしんでいる	壊死	壊死
さいぼうがたんぱくでぶんりしている	蛋白細胞解離	髄液蛋白細胞数解離
さぎょうじむねがいたい	労作時胸痛	反復性胸痛,胸痛
ささやき	嗄声	嗄声
さしこみ	胸部痛,腹痛発作,右下腹部痛,左下腹部痛,右側腹部痛	胸痛,腹痛症,下腹痛,腸仙痛,下腹痛,臍下部痛,側腹部痛
さしこむ	疼痛	疼痛
さぶいぼ	悪寒戦慄	悪寒戦慄
さむけ	悪寒,悪心	悪寒,悪心
さむさをかんじる	悪寒戦慄	悪寒戦慄
さんけ	低酸素血症	低酸素血症
さんそふそくのしょうじょう	低酸素血症	低酸素血症
しくしく痛む	鈍痛	鈍痛
しこり	腫瘤,浮腫,充実性腫瘤,皮下結節　,肺腫瘤,下腿浮腫,腹腔内腫瘤,腫大	腫瘤,浮腫,肺腫瘤,下腿浮腫,腹腔内腫瘤,リンパ節腫大
しこりがある	縦隔リンパ節腫脹,腫大,腫瘤	縦隔リンパ節腫脹,リンパ節腫大,腫瘤
しこりができる	腫瘤形成	腫瘤
しこりの造影	腫瘤像	腫瘤
しごとができないくらいしんどい	労作時呼吸困難	労作時呼吸困難
したが回らない	呂律困難	構音障害
したったらず	失語症	失語症
したばらぽっこり	腹部膨満感	腹部膨満
しっかりと立てない状態	ふらつき	めまい
しっこが出にくい	尿閉	尿閉
しっこが血	血尿	血尿
しっこしにくい	排尿障害	排尿障害
しっこでにくい	排尿困難	排尿困難
しっこでねえ	無尿	無尿
しっこね	無尿状態	無尿
しっこばがりでる	頻尿	多尿,頻尿症
しっしん	皮疹,丘疹,意識レベルの低下,発赤	発疹,丘疹,意識障害,発赤
しっしんが赤い	発赤	発赤
しつごしょう	失語	失語症
しびれ	感覚障害,痙攣,しびれ感,異常感覚,痺れ感,感覚異常,けいれん,温痛覚障害,強直性痙攣,疼痛,知覚障害,感覚鈍麻,末梢循環不全,こわばり	体感異常,痙攣,しびれ感,異常触覚,異常知覚,感覚異常症,温痛覚過敏,強直性痙攣,疼痛,知覚障害,末梢循環不全,こわばり
しびれがきた	痺れ	しびれ感
しびれた	痺れ	しびれ感
しびれた感じ	しびれ感	しびれ感
しびれだ	痙攣	痙攣
しびれている感覚	痺れ感	しびれ感
しびれて震える	けいれん	痙攣
しびれる	しびれ感,けいれん,しびれ,痺れ,痙攣発作,痙攣,疼痛	しびれ感,痙攣,痙攣発作,疼痛
しびれる感じがする	しびれ感	しびれ感
しびれ感	しびれ感	しびれ感
しめつけ	圧痛	圧痛
しもやけ	末梢循環不全	末梢循環不全
しゃっくり	吃逆	横隔膜痙攣症,しゃっくり
しゃべりにくさ	呂律困難	構音障害
しゃべれない	運動性失語,呂律障害,失語症,呂律困難	運動性失語症,構音障害,失語症
しゅだい	肺門リンパ節腫大,全身リンパ節腫大	肺門リンパ節腫脹,リンパ節腫大
しゅちゅう	左下肢腫脹	下肢腫脹
しゅちょう	全身性リンパ節腫脹,耳下腺腫脹	リンパ節症,耳下腺腫脹
しゅっけけつ	大量出血	多量出血
しゅっけつ	活動性出血,性器出血,大量出血	出血,性器出血,多量出血
しゅっけつはん	出血斑	斑状出血
しゅようがおおきくなった	腫大	リンパ節腫大
しゅようができた	腫瘤形成	腫瘤
しゅようのこぶのがぞう	腫瘤像	腫瘤
しゅようのびょうじょうがかわる	腫瘤病変	腫瘤
しゅりょう	髄外腫瘤,腫瘤病変,腹腔内腫瘤,頚部腫脹,巨大腫瘤	腫瘤,腹腔内腫瘤,頚部腫脹
しょうかふりょう	摂食不良	摂食機能障害
しょうがい	嚥下機能障害	嚥下協調障害,嚥下障害
しょうこうねつ	微熱	微熱
しょうべんがでない	尿閉	尿閉
しょうべんがひんぱんにしたくなる	頻尿	多尿,頻尿症
しょうべんにちがまざる	尿潜血	顕微鏡的血尿
しょくよくがない	食欲不振	食欲不振
しょくよくふしん	食欲低下,食思不振	食欲不振
しょっちゅうトイレに行く	頻尿	多尿,頻尿症
しわがれごえ	嗄声	嗄声
しわがれた声	嗄声	嗄声
しわがれ声	嗄声	嗄声
しわぶき	咳	咳
しんえい	心陰影拡大,心陰影	胸部異常陰影
しんかぶに不快感を感じる	心窩部不快感	心窩部不快
しんせん	安静時振戦	静止時振戦
しんぞうがどきどきする	動悸発作,動悸	動悸
しんぞうのみゃくがふせいみゃく	心雑音	心雑音
しんぞうぶがいたい	心窩部痛	心窩部痛
しんどい	疲労感,易疲労感,脱力感	疲労感,易疲労感,脱力感
しんぱいていし	呼吸停止	呼吸停止
じっとしているときでも震えが出ること	安静時振戦	静止時振戦
じっとしているときに呼吸が困難なこと	安静時呼吸困難	呼吸困難
じっとしているときに胸が痛いこと	安静時胸痛	反復性胸痛,胸痛
じょうえい	線状影	胸部異常陰影
じょうかくリンパ節が大きくなる	縦隔リンパ節腫大	縦隔リンパ節腫脹
じょうみゃく	徐脈性不整脈	徐脈性不整脈
じょうみゃくにあながあいた	洞性頻脈（どうせいじょうみゃく）	
じょみゃく	徐脈性不整脈	徐脈性不整脈
じょみゃくがふせいみゃく	徐脈性不整脈	徐脈性不整脈
じわじわした痛み	鈍痛	鈍痛
じんじん	痛み	疼痛
じんじんする	痺れ,しびれ感,拍動性頭痛,疼痛	しびれ感,頭痛,疼痛
じんじん痛い	疼痛	疼痛
じんましん	発赤腫脹,発疹,発赤,皮疹,皮膚黄染,粘膜発赤	発赤,発疹,黄疸
じんわり痛い	鈍痛	鈍痛
じーっとしている時にプルプルと手先が震える	安静時振戦	静止時振戦
じーっと沈黙してしまう	寡動	行動緩慢
すいぞうひだい	膵腫大	膵腫大
すい臓の液体の腫瘤	嚢胞性腫瘤	腫瘤
すい臓の腫れ	膵腫大	膵腫大
すこし体温が高い	微熱	微熱
すごくだるい	全身倦怠感	全身倦怠感
すごく痛い	激痛	疼痛
すりがらすかげ	スリガラス影	胸部異常陰影
すりガラスで見たら影がある	スリガラス陰影	胸部異常陰影
すりガラスのように曇った部分のある画像検査結果	スリガラス陰影	胸部異常陰影
すりガラス陰影	スリガラス陰影	胸部異常陰影
すり足	失調性歩行	失調性歩行
ずきずき	頭痛	頭痛
ずきずきいたい	疼痛	疼痛
ずきずきする痛み	鈍痛	鈍痛
ずきずき痛い	疼痛	疼痛
ずきずき痛む	疼痛	疼痛
ずっと咳しとる	慢性咳嗽	慢性咳嗽
ずつう	頭部痛	頭痛
せいじょうにはなせない	呂律障害	構音障害
せいづつう	拍動性頭痛	頭痛
せいり	性器出血	性器出血
せき	咳嗽,乾性咳嗽,湿性咳嗽,吐気,乾性咳	咳,乾性咳,湿性咳,慢性咳嗽,嘔気
せきがいつもでる	慢性咳嗽	慢性咳嗽
せきが出る	咳嗽,乾性咳,咳	咳,乾性咳
せきこむ	咳嗽	咳
せきこんこん	咳	咳
せきのこと	咳嗽	咳
せっしょく	摂食不良	摂食機能障害
せつしゅお	両側肺門部リンパ節腫脹	肺門リンパ節腫脹
せん妄	幻覚	幻覚
ぜいぜい	喘鳴	喘鳴
ぜいぜいする	息切れ,喘鳴	息切れ,喘鳴
ぜいぜいとした息	喘鳴	喘鳴
ぜいぜいと息をする	喘鳴	喘鳴
ぜいぜいと音がする呼吸	喘鳴	喘鳴
ぜいぜい言う	喘鳴	喘鳴
ぜいぜい音をたてて呼吸する	喘鳴	喘鳴
ぜいはあする	息切れ	息切れ
ぜろぜろした咳	湿性咳嗽	湿性咳,慢性咳嗽
ぜんしんがはれている	全身性浮腫	全身性浮腫
ぜんしんのりいぱせつがはれている	全身リンパ節腫脹	リンパ節腫大
ぜんそく	気管支透亮像,喘鳴	胸部異常陰影,喘鳴
ぜんそくのせき	喘鳴	喘鳴
ぜーぜー	喘鳴	喘鳴
ぜーぜーという	喘鳴	喘鳴
ぜーぜーと音がする	喘鳴	喘鳴
ぜーぜーゆう	喘鳴	喘鳴
そくふく	側腹部痛	側腹部痛
そのものがもつエネルギー	熱	発熱
そばかす	粒状陰影	胸部異常陰影
ぞう	下腿浮腫	下腿浮腫
ぞくぞくする	悪寒	悪寒
ぞっとする	悪寒戦慄	悪寒戦慄
たいそい	倦怠感,全身倦怠感	倦怠感,全身倦怠感
たくさんのぞうきがいじょう	多臓器障害	多臓器不全
たくさんの臓器に問題がある	多臓器障害	多臓器不全
たくさんの血が出る	大量出血	多量出血
たくさん尿が出る	多飲多尿	多飲症,多尿
たくさん水分をとりたくさん尿が出る	多飲多尿	多飲症,多尿
たくさん水分を取ったため尿がたくさん出てる	多飲多尿	多飲症,多尿
たくさん水分を取りたくさん排尿する	多飲多尿	多飲症,多尿
たくさん水分を摂ってたくさんおしっこがでる	多飲多尿	多飲症,多尿
たくさん血が出る	活動性出血,大量出血	出血,多量出血
たくさん飲む	多飲	多飲症
たくさん飲むからよくトイレ行く	多飲多尿	多飲症,多尿
たくさん飲んでたくさんオシッコが出る	多飲多尿	多飲症,多尿
たくさん飲んでたくさん尿が出る	多飲多尿	多飲症,多尿
たくさん飲んで沢山おしっこをする	多飲多尿	多飲症,多尿
たこ	痂皮	痂皮
たこつぼ症状	房室回帰性頻拍	頻拍症
ただれ	皮疹	発疹
たちくらみ	眩暈,一過性意識障害,めまい,めまい感	めまい,一過性意識障害,めまい感
たっぷんたっぷん	腹水貯留	腹水症
たてほうこうにりんぱせんがはれた	縦隔リンパ節腫脹	縦隔リンパ節腫脹
たべたあとけっとうちがたかくなる	食後高血糖	高血糖症
たべたくない	食欲不振	食欲不振
たべたとき、あじが、おかしい。	味覚障害	味覚障害
たべたなくなる	食欲低下	食欲不振
たべられない	経口摂取困難	経口摂取困難
たべるきがひくい	食欲低下	食欲不振
たべれん	食欲不振	食欲不振
たん	喀痰,咳嗽	喀痰,咳
たんから血液が出る	血痰	血痰
たんがからむ	喀痰	喀痰
たんがからむせき	湿性咳嗽	湿性咳,慢性咳嗽
たんがこい	膿性痰	膿性痰
たんがでる	痰	喀痰
たんが絡んで咳が出る	湿性咳嗽	湿性咳,慢性咳嗽
たんこぶ	圧痕浮腫,髄外腫瘤,腫瘤	浮腫,腫瘤
たんじゅうがでる	痰	喀痰
たんぱく	高度蛋白尿	蛋白尿
たんぱくが出る	尿蛋白	蛋白尿
たんぱくでる	蛋白尿,尿蛋白	蛋白尿
たんぱくにょう	高度蛋白尿	蛋白尿
たんぱく質	高度蛋白尿	蛋白尿
たんぺ	痰	喀痰
たんをはく	喀痰	喀痰
だつりょく	下肢脱力	下肢脱力感
だつりょくかん	下肢脱力	下肢脱力感
だらーんとなる	脱力感	脱力感
だるい	全身倦怠感,倦怠感,虚脱,脱力,脱力感,疲労感,易疲労感,四肢脱力感,四肢脱力,四肢筋力低下	全身倦怠感,倦怠感,虚脱,脱力感,筋脱力,脱力感,疲労感,易疲労感,四肢脱力感,四肢脱力,四肢筋力低下
だるい感じ	倦怠感,全身倦怠感	倦怠感,全身倦怠感
だるくて力が出ない感じ	脱力感	脱力感
だるけ	虚脱	虚脱
だるさ	全身倦怠感,倦怠感,虚脱,疲労感,脱力感,右上肢脱力	全身倦怠感,倦怠感,虚脱,疲労感,脱力感
だるさがある	倦怠感	倦怠感
ちいさなしゅりょう	低エコー腫瘤	腫瘤
ちからが出ない	下肢脱力	下肢脱力感
ちがでた	出血,性器出血	出血,性器出血
ちがでたあと	出血斑	斑状出血
ちがでる	出血	出血
ちがまたでた	再出血	出血
ちが出た	活動性出血	出血
ちくのう	膿性痰	膿性痰
ちゅーぶ	振戦	振戦
ちょうにしゅようがある	腸管浮腫	浮腫
ちょっとした発熱	微熱	微熱
ちょっと動くと息が苦しい感じ	労作時呼吸困難感	労作時呼吸困難
ちょっと圧迫されて痛い	軽度圧痛	圧痛
ちょっと熱あるなぁ	微熱	微熱
ちょっと熱がある	微熱	微熱
ちょっと脈が乱れとる	徐脈性不整脈	徐脈性不整脈
ぢいっぺえででぎだ	大量出血	多量出血
ぢでだ	出血	出血
ついうっかり	物忘れ	健忘症
つかれ	疲労感	疲労感
つかれている	疲労感	疲労感
つっぱり	こわばり	こわばり
つっぱる	こわばり	こわばり
つっぱる感じがする	こわばり	こわばり
つば	痰	喀痰
つらい	痛み	疼痛
つる	痙攣,けいれん	痙攣
つること	強直性痙攣	強直性痙攣
つんぼ	知覚障害	知覚障害
てあしがむくむ症状	四肢浮腫	四肢浮腫
てあしのきんにくがさがった	四肢筋力低下	四肢筋力低下
てあしのちからがよわい	四肢脱力	四肢脱力
ていか	記銘力低下	記銘力低下
ていかする	温痛覚低下	知覚鈍麻
てんかん	痙攣発作,痙攣重積状態,けいれん発作,失神発作,痙攣重積,意識消失発作,強直性痙攣	痙攣発作,痙攣重積発作,てんかん様発作,痙攣発作,痙攣重積発作,全身痙攣発作,失神,眼前暗黒,虚脱,血管迷走神経性失神,失神,心臓性失神,卒倒,単純性失神,排尿性失神,労作性失神,強直性痙攣
てんかんの発作	失神発作	失神
てんかん発作	全身性痙攣,強直性痙攣,痙攣発作	全身痙攣,強直性痙攣,痙攣発作
てんでん	点状出血	点状出血
てんのかたちでちがでた	点状出血	点状出血
でかいタンコブ	巨大腫瘤	腫瘤
でかい塊	巨大腫瘤	腫瘤
できもの	腸管浮腫,腫瘤,皮下腫瘤,浮腫,丘疹,腫瘍性病変,発疹,黄疸,全身浮腫,多発性腫瘤,腫大,皮疹,腫瘤像,下腿浮腫,腫瘤形成,紅色丘疹,両側下腿浮腫,圧痕浮腫,脾腫,両下腿浮腫,頚部リンパ節腫脹,両下肢浮腫,巨大腫瘤,発赤	浮腫,腫瘤,皮下腫瘤,丘疹,-1,発疹,黄疸,全身性浮腫,リンパ節腫大,下腿浮腫,紅色丘疹,脾腫,頚部リンパ節腫脹,下肢浮腫,発赤
できものがあちこちにできる症状	多発腫瘤,多発性腫瘤	腫瘤
できものがある	腫瘤像	腫瘤
できものができている	腫瘤形成	腫瘤
できものが出来る	腫瘤形成	腫瘤
できものが大きくなる	腫大	リンパ節腫大
できもののような影	腫瘤像	腫瘤
できものの一種	嚢胞性腫瘤	腫瘤
できものの変化	浮腫状変化,浮腫性変化	浮腫
できものの大きさ	腫大	リンパ節腫大
できものの形	腫瘤形成	腫瘤
できもん	腫瘤	腫瘤
でっぱり	腫瘤	腫瘤
でぶ	体重増加,膨満	体重増加,腹部膨満
でら痛い	激痛	疼痛
とうつう	癌性疼痛,拍動性頭痛,下肢疼痛	癌性疼痛,頭痛,疼痛
とうにたいおうできないしょうがい	耐糖能障害	耐糖能異常
とうにょう	境界型糖尿病	境界型糖尿病
とうにょうびょう	境界型糖尿病	境界型糖尿病
とけつ	血痰	血痰
ところどころ出血	点状出血	点状出血
とつぜんてきにしぼうした	突然死	突然死
とつぜん気を失う	失神発作	失神
とても痛い	激痛	疼痛
とびひ	丘疹	丘疹
とろくなる	寡動	行動緩慢
とーにょー	境界型糖尿病	境界型糖尿病
どうえい	空洞影	胸部異常陰影
どうしたのだろう	異常行動	異常行動
どうせいひんみゃく	洞性頻脈（どうせいじょうみゃく）	
どうでもいい	虚脱	虚脱
どきどきする	動悸,頻脈	動悸,頻脈症,洞頻脈
どこか痛い	下腹部痛,上腹部痛	下腹痛,上腹部痛
どっかおかしい	嚥下障害	嚥下障害
どもり	吃逆,呂律不良,呂律障害,構音障害	横隔膜痙攣症,しゃっくり,不明瞭言語,構音障害
どもる	構音障害,呂律困難	構音障害
どんかん	感覚鈍麻	感覚異常症
どんどんと血が出る	活動性出血	出血
どんま	感覚鈍麻	感覚異常症
ない	浮腫	浮腫
ないしゅっけつ	出血斑	斑状出血
なおりにくい腹に水が溜まる症状	難治性腹水	難治性腹水
なす	ｍａｓｓ	腫瘤
なにかがある	下腿浮腫	下腿浮腫
なめらかに話せない	失語	失語症
なんか知らんけど動くと息がしんどい	労作時呼吸困難	労作時呼吸困難
なんか顔とか黄色いで	黄疸	黄疸
なんだ	落屑	鱗屑
なんだっけ	物忘れ	健忘症
なんや股んとこ腫れとる	リンパ節腫脹	リンパ節腫大
にえる	皮下出血,皮下出血斑	皮下出血
においをただしくかんじない	味覚異常	味覚異常
にきび	紅色丘疹,皮疹	紅色丘疹,発疹
にさんか	高二酸化炭素血症	高炭酸ガス血症
にさんかたんそなるこーしす	CO２ナルコーシス	
にし	吃逆,ｆｉｎｅ　ｃｒａｃｋｌｅｓ	横隔膜痙攣症,しゃっくり,湿性ラ音
にぶい	感覚鈍麻,知覚障害	感覚異常症,知覚障害
にぶいいたみ	鈍痛	鈍痛
にぶい痛み	鈍痛,疼痛	鈍痛,疼痛
にぶちん	感覚鈍麻	感覚異常症
にやにや	腹部違和感	腹部不快感
にょうがちゃいろ	褐色尿	ビリルビン尿
にょうがでない	尿閉	尿閉
にょうにたんぱくがでた	蛋白尿	蛋白尿
にょうにたんぱくがまざる	高度蛋白尿	蛋白尿
にんち	失調性歩行	失調性歩行
ぬけがら	虚脱	虚脱
ぬすみあせ	盗汗	寝汗
ねあせ	盗汗	寝汗
ねっぱつ	熱発,発熱	発熱
ねつ	熱	発熱
ねつがある	発熱	発熱
ねつがでた	熱発	発熱
ねつっぽい	熱感,不明熱	ほてり,不明熱
ねづあっぺ	微熱	微熱
ねんまくにすいぶんがおおい	粘膜浮腫	浮腫
のうほうじょうのしゅよう	嚢胞性腫瘤	腫瘤
のおうほう	嚢胞内出血	内出血
のどかわいた	多飲	多飲症
のどがイガイガ	咳	咳
のどが渇いた	口渇	口渇症
のどが渇く	口渇感,口渇	口渇症
のどが痛い	リンパ節腫脹,粘膜発赤,嚥下痛	リンパ節腫大,発赤,嚥下痛
のどが腫れる	頚部腫脹	頚部腫脹
のどが鳴る	喘鳴	喘鳴
のどなり	喘鳴	喘鳴
のどの奥から出てくる粘りのある液体	痰	喀痰
のどの痛み	嚥下痛	嚥下痛
のど詰まり	嚥下機能障害	嚥下協調障害,嚥下障害
のぼせ	熱感	ほてり
のみこみずらい	嚥下痛	嚥下痛
のみこむのがこんなん	嚥下困難感	嚥下困難
のみこめない	嚥下困難感,嚥下障害,経口摂取不良,嚥下困難	嚥下困難,嚥下障害,摂食機能障害
のみこめん	嚥下機能障害	嚥下協調障害,嚥下障害
のみすぎ	大量腹水	腹水症
のんびり	寡動	行動緩慢
のんべえ	多飲	多飲症
はあはあと息をする	息切れ	息切れ
はあはあ言う	息切れ	息切れ
はい	びまん性肺胞出血	肺胞出血
はいえい	肺結節影	肺部異常陰影
はいがえきでみたされている影	肺浸潤影	肺部異常陰影
はいけっしょう	肺結節影	肺部異常陰影
はいけつせっえい	肺結節影	肺部異常陰影
はいけつせつえい	肺結節影	肺部異常陰影
はいしゅりゅう	肺腫瘤	肺腫瘤
はいた	嘔吐	嘔吐症
はいで出血	肺出血	肺出血
はいにちがでた	肺出血	肺出血
はいにょう	排尿時痛	排尿痛
はき	吐気	嘔気
はきくだし	嚥下機能障害	嚥下協調障害,嚥下障害
はきけ	嘔気,吐気,悪心,悪心嘔吐,嘔気嘔吐	嘔気,悪心,悪心,嘔吐症,嘔気,嘔吐症
はきけがする	嘔気嘔吐	嘔気,嘔吐症
はき気	嘔気	嘔気
はく	嘔吐,嘔気	嘔吐症,嘔気
はげしいいたみ	激痛	疼痛
はだがきいろくなる	黄疸	黄疸
はだのしたでふしがいたい	皮下結節　	
はっか	発赤	発赤
はっきりしたしこり	充実性腫瘤	腫瘤
はっきりしない痛み	鈍痛	鈍痛
はっきりとしない	意識レベルの低下	意識障害
はっきり写らない画像	スリガラス影	胸部異常陰影
はっしん	皮疹	発疹
はっせき	発赤	発赤
はっている	膨満	腹部膨満
はつねつ	微熱	微熱
はなじ	鼻出血	鼻出血症,鼻血
はなすことがむずかしい	呂律困難	構音障害
はなせない	失語症	失語症
はなぢ	鼻出血	鼻出血症,鼻血
はなぢぶう	鼻出血	鼻出血症,鼻血
はらいた	腹痛,上腹部痛,急性腹症,腹痛発作,腹部痛,下腹部痛,右下腹部痛,左下腹部痛,右上腹部痛,腹部違和感,左側腹部痛,右側腹部痛	腹痛症,腹壁痛,仙痛,上腹部痛,急性腹症,腹痛症,下腹痛,下腹痛,腸仙痛,下腹痛,臍下部痛,腹部不快感,側腹部痛
はらいたほっさ	腹痛発作	腹痛症
はらいでえ	腹痛	腹痛症,腹壁痛,仙痛
はらいわす	腹部痛,腹部不快感,下腹部痛	腹痛症,腹部不快感,下腹痛
はらうずい	腹部違和感	腹部不快感
はらが痛い状態	腹痛	腹痛症,腹壁痛,仙痛
はらきもわる	上腹部不快感	腹部不快感
はらこわし	腹水	腹水症
はらにたまる水	腹水	腹水症
はらにみずがおおくたまる	大量腹水	腹水症
はらのしゅよう	腹部腫瘤	腹部腫瘤
はらのなかのできもの	腹腔内腫瘤	腹腔内腫瘤
はらのはり	腹部膨満感	腹部膨満
はらのリンパ節がはれた	腹腔内リンパ節腫大	リンパ節腫大
はらぼて	腹部膨隆	腹部膨満
はり	左下肢腫脹,左下腿腫脹,線状影,こわばり	下肢腫脹,下腿腫脹,胸部異常陰影,こわばり
はりがある	膨満	腹部膨満
はれ	頚部リンパ節腫脹,むくみ,両側肺門部リンパ節腫脹,左頚部リンパ節腫脹,腫大	頚部リンパ節腫脹,浮腫,肺門リンパ節腫脹,リンパ節腫大
はれてる	むくみ	浮腫
はれもの	腫瘤,両側下腿浮腫,全身性浮腫,脾腫,腫大	腫瘤,下腿浮腫,全身性浮腫,脾腫,リンパ節腫大
はれものがある	低エコー腫瘤	腫瘤
はれる	発赤腫脹,腫大	発赤,リンパ節腫大
はれ物　	腫瘤	腫瘤
ばい菌を包んだネパッこいもの	痰	喀痰
ばか	味覚異常	味覚異常
ばくつき	動悸	動悸
ばくばく	頻拍	頻拍症
ひえしょう	末梢循環不全	末梢循環不全
ひかいじょう	皮下出血斑	皮下出血
ひきつけ	けいれん,痙攣重積状態,こわばり,けいれん発作,痙攣発作	痙攣,痙攣重積発作,こわばり,てんかん様発作,痙攣発作,痙攣重積発作,全身痙攣発作,痙攣発作
ひきつり	痙攣,けいれん,痙攣発作,こわばり	痙攣,痙攣発作,こわばり
ひくひく	痙攣	痙攣
ひじょうにちいさなけつにゅう	顕微鏡的血尿	顕微鏡的血尿
ひだり	左下腿腫脹	下腿腫脹
ひだりあしがはれた	左下肢腫脹	下肢腫脹
ひだりがわふくぶつう	左側腹部痛	側腹部痛
ひだりのまえのむねがいたい	左前胸部痛	前胸部痛
ひだりのむねがいたい	左側胸部痛,右側胸部痛	側胸部痛,胸痛
ひだりのむねのいたみ	左胸痛	胸痛
ひだりむね	左前胸部痛	前胸部痛
ひだりむねいた	左胸部痛	胸痛
ひだりむねいわす	左胸痛	胸痛
ひだりむねぶつう	左胸部痛	胸痛
ひどい咳	咳嗽	咳
ひどい浮腫み	腫大	リンパ節腫大
ひどい疲れに襲われる	疲労感	疲労感
ひどい痛み	激痛	疼痛
ひどく痺れる状態が続いている	痙攣重積	痙攣重積発作
ひどく脈が早い心臓に原因	房室回帰性頻拍	頻拍症
ひび	ｆｉｎｅ　ｃｒａｃｋｌｅｓ	湿性ラ音
ひふのしゅようがへんかした	浮腫性変化	浮腫
ひまん	膨満	腹部膨満
ひゃっくり	呼吸筋麻痺,吃逆	呼吸麻痺,横隔膜痙攣症,しゃっくり
ひやあせ	盗汗	寝汗
ひゅうひゅうという呼吸音	喘鳴	喘鳴
ひんにょう	夜間頻尿,乏尿,多飲多尿	夜間頻尿症,乏尿,多飲症,多尿
ひんみゃく	頻拍	頻拍症
ひんみゃくほっさ	動悸発作	動悸
ひんんつおう	夜間頻尿	夜間頻尿症
ひーひー	喘鳴	喘鳴
びくびく	痙攣	痙攣
びくびくする	痙攣発作	痙攣発作
びっこ	歩行障害	歩行障害
びっこを引く	歩行困難	歩行困難
びまん	びまん性粒状影	胸部異常陰影
びまん性の粒のような影がレントゲンで映る	びまん性粒状影	胸部異常陰影
びまん性小粒状影	びまん性粒状影	胸部異常陰影
びまん性肺胞出血	肺胞出血,心窩部不快感	肺胞出血,心窩部不快
びまん性肺胞出血症候群	びまん性肺胞出血	肺胞出血
びまん状の影	びまん性粒状影	胸部異常陰影
びらん	粘膜発赤,びまん性粒状影	発赤,胸部異常陰影
びりびり	痺れ,しびれ	しびれ感
びりびりぐる	しびれ	しびれ感
びりびりする	しびれ感,しびれ,痺れ感,痺れ	しびれ感
びりびり感	痺れ感	しびれ感
びれる	痺れ	しびれ感
びんぼうゆすり	安静時振戦	静止時振戦
ぴりぴりした感覚で平常でなくなる	痺れ	しびれ感
ぴりぴりする	しびれ感	しびれ感
ふえいまや	頻脈性不整脈	頻脈性不整脈
ふかい	胃部不快感	腹部不快感
ふかいかん	上腹部不快感	腹部不快感
ふくしさりょう	巨大腫瘤	腫瘤
ふくすいがなおるのはむずかしい	難治性腹水	難治性腹水
ふくすいに、ちが、まざる。	血性腹水	血性腹水
ふくつう	腹部痛,腹痛発作	腹痛症
ふくぶ	腹部膨隆	腹部膨満
ふくぶ異常	腹部違和感	腹部不快感
ふくまん	大量腹水	腹水症
ふくらはぎがむくむ	下腿浮腫	下腿浮腫
ふくらはぎのむくみ	下腿浮腫	下腿浮腫
ふくらみ	膨満	腹部膨満
ふくれる	むくみ	浮腫
ふけ	痂皮	痂皮
ふしくれ	皮下結節　	
ふしゅ	粘膜浮腫,むくみ,圧痕浮腫	浮腫
ふせいみゃく	頻脈性不整脈,徐脈性不整脈	頻脈性不整脈,徐脈性不整脈
ふつうにあるけない	歩行障害	歩行障害
ふとりすぎではいからちがでる	びまん性肺胞出血	肺胞出血
ふとる	体重増加	体重増加
ふめい	感覚障害	体感異常
ふらつき	眩暈,めまい,浮動性めまい,めまい感,歩行困難,歩行障害	めまい,めまい感,歩行困難,歩行障害
ふらつき感	めまい感	めまい感
ふらつく	構音障害,めまい,歩行困難,浮動性めまい,失調性歩行,眩暈	構音障害,めまい,歩行困難,失調性歩行
ふらつくこと	眩暈	めまい
ふらふら	ふらつき,めまい,歩行困難	めまい,歩行困難
ふらふらする	ふらつき,眩暈,浮動性めまい,めまい感,失調性歩行,めまい,意識レベルの低下,意識障害	めまい,めまい感,失調性歩行,意識障害
ふらふらとした不安定でぎこちない歩行	失調性歩行	失調性歩行
ふらふらと歩く	失調性歩行	失調性歩行
ふらふらゆれている感じ	浮動性めまい	めまい
ふりょう	顔色不良,経口摂取不良	顔面蒼白,摂食機能障害
ふるえ	振戦,手指振戦,安静時振戦,けいれん発作,けいれん,痙攣	振戦,手指振戦,静止時振戦,てんかん様発作,痙攣発作,痙攣重積発作,全身痙攣発作,痙攣
ふるえる	振戦,痙攣	振戦,痙攣
ふるえる発作	痙攣発作	痙攣発作
ふわふわ	意識障害	意識障害
ふわふわする	浮動性めまい	めまい
ふわふわする  	めまい	めまい
ふわふわするめまい	浮動性めまい	めまい
ふわふわする感じ	浮動性めまい	めまい
ふわふわとしためまい	浮動性めまい	めまい
ぶじじ	皮下出血斑	皮下出血
ぶつう	右胸部痛,左上腹部痛	側胸部痛,上腹部痛
ぶつぶつ	発疹,皮疹	発疹
ぶつぶつができる	発疹	発疹
ぶつぶつが出る	発疹	発疹
ぶつぶつが出来る	発疹	発疹
ぶづぶづでぎだ	皮疹	発疹
ぶるぶるする	痙攣	痙攣
へいじょうでない行動	異常行動	異常行動
へその上あたりのおなかが嫌な感じ	上腹部不快感	腹部不快感
へたれている	意識レベルの低下,易疲労感	意識障害,易疲労感
へんか	浮腫状変化	浮腫
へんだ	異常行動	異常行動
ほうけている	意識レベルの低下	意識障害
ほこう	失調性歩行	失調性歩行
ほっさ	動悸発作	動悸
ほっしん	皮疹	発疹
ほっせき	粘膜発赤	発赤
ほてり	熱感,微熱,熱	ほてり,微熱,発熱
ほてる	微熱	微熱
ほほがピンク	CO２ナルコーシス	
ぼうしつ	房室回帰性頻拍	頻拍症
ぼうっとしている	意識レベルの低下	意識障害
ぼうまん	膨満	腹部膨満
ぼうりゅうしん	丘疹	丘疹
ぼけ	記銘力低下,物忘れ,記憶障害	記銘力低下,健忘症,記憶障害
ぼけている	見当識障害	見当識障害
ぼける	物忘れ	健忘症
ぼっぐり	突然死	突然死
ぼつぼつ	発疹,皮疹	発疹
ぼつぼつができる	発疹	発疹
ぼんやりしている	軽度意識障害	意識障害
ぼんやりして返事があいまい	意識障害	意識障害
ぼーっとする	意識レベルの低下,意識障害	意識障害
ぽっかりあいたように見える影	空洞影	胸部異常陰影
ぽっくり	突然死	突然死
ぽっくり死ぬ	突然死	突然死
ぽっくり病	突然死	突然死
ぽっくり逝く	突然死	突然死
またちがでてきたー	再出血	出血
また出血した	再出血	出血
また血ぃ出た	再出血	出血
また血がでる	再出血	出血
また血が出た	再出血	出血
また血が出る	再出血	出血
まだら	出血斑	斑状出血
まだらな出血	点状出血	点状出血
まだらに赤くなっとる	点状出血	点状出血
まっすぐ歩けない	失調性歩行	失調性歩行
まっすぐ立てない	ふらつき	めまい
まったく有酸素呼吸をしないこと	無呼吸	無呼吸発作
まともに歩けない	失調性歩行	失調性歩行
まひ	温痛覚低下,しびれ,痺れ,四肢脱力,けいれん,痙攣,感覚障害	知覚鈍麻,しびれ感,四肢脱力,痙攣,体感異常
まひなどが重なって起きてる	痙攣重積状態	痙攣重積発作
まひなどが重なる	痙攣重積	痙攣重積発作
まひる	感覚障害	体感異常
まぼろし	幻覚	幻覚
まぼろしが見える症状	幻覚	幻覚
まんぷく	腹満感	腹部膨満
みぎのはらがいたい。	右上腹部痛	上腹部痛
みぎのむねがいたい	右胸痛	胸痛
みぎばらいわす	右下腹部痛	下腹痛,腸仙痛
みぎむねいた	右胸部痛	側胸部痛
みぎむねいわす	右胸痛,右側胸部痛	胸痛
みぎむねぶつう	右胸部痛	側胸部痛
みず	大量腹水,腹水	腹水症
みずがたまる	膵性胸水	胸水検査異常
みずっぱら	大量腹水	腹水症
みずぶくれ	腹水	腹水症
みぞうち痛	上腹部不快感	腹部不快感
みぞおちあたりが気持ち悪い	心窩部不快感	心窩部不快
みぞおちが変	心窩部不快感	心窩部不快
みぞおちが快適でない感じ	心窩部不快感	心窩部不快
みぞおちが痛い	心窩部痛,上腹部痛	心窩部痛,上腹部痛
みぞおちが痛いこと	心窩部痛	心窩部痛
みぞおちの下の痛み	上腹部痛	上腹部痛
みぞおちの不快	心窩部不快感	心窩部不快
みぞおちの不快感	心窩部不快感	心窩部不快
みぞおちの痛み	心窩部不快感,心窩部痛	心窩部不快,心窩部痛
みぞおちの違和感	心窩部不快感	心窩部不快
みぞおち不快感	心窩部不快感	心窩部不快
みぞおち痛	心窩部不快感,心窩部痛	心窩部不快,心窩部痛
みぞおち違和感	上腹部不快感	腹部不快感
みぞおち部分に感じる不快な感覚	心窩部不快感	心窩部不快
みみしたせんしゅちょう	耳下腺腫脹	耳下腺腫脹
みゃくがない	頻脈性不整脈	頻脈性不整脈
むかついて吐く	嘔気嘔吐	嘔気,嘔吐症
むかつき	上腹部不快感,悪心,胃部不快感,吐き気,胸部不快感,悪心嘔吐,心窩部不快感,胸部圧迫感,胸部違和感	腹部不快感,悪心,嘔気,胸部不快感,悪心,嘔吐症,心窩部不快,胸内苦悶
むかつく	吐き気	嘔気
むかむか	上腹部不快感	腹部不快感
むかむかする	悪心,上腹部不快感	悪心,腹部不快感
むきりょく	記銘力低下	記銘力低下
むくみ	浮腫,下腿浮腫,全身浮腫,全身性浮腫,浮腫性変化,圧痕性浮腫,浮腫状変化,粘膜浮腫,圧痕浮腫,腫大,下肢浮腫,両下腿浮腫,顔面浮腫,四肢浮腫,両下肢浮腫,全身リンパ節腫脹,軽度腫大,ｐｉｔｔｉｎｇ　ｅｄｅｍａ,むくみ,皮下腫瘤,両側下腿浮腫,腹水	浮腫,下腿浮腫,全身性浮腫,リンパ節腫大,下肢浮腫,顔面浮腫,四肢浮腫,皮下腫瘤,腹水症
むくみがたくさん発生	多発性腫瘤	腫瘤
むくみができること	浮腫性変化	浮腫
むくみが多数ある	多発腫瘤	腫瘤
むくみのある部分を押して放置してもあとが残るもの	ｐｉｔｔｉｎｇ　ｅｄｅｍａ	浮腫
むくみのこと	浮腫	浮腫
むくむ	浮腫,下肢浮腫,全身浮腫,両下腿浮腫,浮腫性変化,両下肢浮腫,皮下腫瘤	浮腫,下肢浮腫,全身性浮腫,下腿浮腫,皮下腫瘤
むくんだ状態に変化	浮腫状変化	浮腫
むくんでいる	むくみ	浮腫
むくんどる	浮腫状変化	浮腫
むしさされ	皮下出血斑	皮下出血
むすび	硬結	硬結
むせる	咳嗽,咳	咳
むないでえ	胸痛	胸痛
むなぐるしい	胸部絞扼感	胸部不快感
むにょう	無尿状態	無尿
むねいた	胸痛	胸痛
むねいわす	胸部不快感,胸部痛,胸部違和感	胸部不快感,胸痛
むねおされるかん	前胸部圧迫感	胸部不快感
むねがいたい	胸痛,胸部痛,胸痛発作	胸痛
むねがおかしい	胸部違和感	胸部不快感
むねがざわざわする	胸部違和感	胸部不快感
むねがしめつけられる	胸部絞扼感	胸部不快感
むねのいたみ	前胸部圧迫感,右胸部痛,左胸部痛,胸苦	胸部不快感,側胸部痛,胸痛
むねのかげ	胸部異常影	胸部異常陰影
むねやけ	上腹部不快感,腹部不快感,胸痛	腹部不快感,胸痛
むね痛	胸部痛	胸痛
めがくらむ	眩暈	めまい
めちゃ血出る	大量出血	多量出血
めっさいたい	激痛	疼痛
めっちゃ痛い	激痛	疼痛
めまい	ふらつき,めまい感,浮動性めまい,眼前暗黒感,意識障害,頭重感,軽度意識障害,めまい,一過性意識障害	めまい,めまい感,眼前暗黒,意識障害,頭重感,一過性意識障害
めまいがする	ふらつき,めまい感	めまい,めまい感
めまいがする感じ	めまい感	めまい感
めまいぶっごぎ	意識障害	意識障害
めまう	眩暈,めまい	めまい
もうすでに死んでいる	壊死	壊死
もうろう	意識レベルの低下,意識障害,意識混濁	意識障害,意識混濁
もうろうとしてる	昏迷	昏迷
もうろうとする	意識レベルの低下	意識障害
もう一度出血すること	再出血	出血
もう覚えられない	記銘力低下	記銘力低下
もたれ	腹部不快感,膨満	腹部不快感,腹部膨満
もどしそう	嘔気	嘔気
もどす	嘔吐,吐き気	嘔吐症,嘔気
ものが呑み込めない	嚥下障害	嚥下障害
ものが見にくい	眼前暗黒感	眼前暗黒
ものが食べにくい	嚥下障害	嚥下障害
ものが食べれない	経口摂取困難	経口摂取困難
ものに触る感覚や熱い冷たいなどの感覚が正しくわからない症状	感覚異常	感覚異常症
ものわすれ	記銘力低下	記銘力低下
もの覚えが悪い	記銘力障害	記銘力低下,記憶障害
ももがむくむ	下腿浮腫	下腿浮腫
もものしゅよう	下腿浮腫	下腿浮腫
もれ	夜間頻尿	夜間頻尿症
やし	全身浮腫,痺れ	全身性浮腫,しびれ感
やせた	体重減少	体重減少
やせる	体重減少	体重減少
やめる　	痛み	疼痛
ややねつっぽい	微熱	微熱
やや熱がある	微熱	微熱
やるきがない	倦怠感	倦怠感
やる気がでない	脱力	脱力感,筋脱力
やる気が出ない	虚脱,倦怠感	虚脱,倦怠感
やる気が起きない。	全身倦怠感	全身倦怠感
やる気なし	脱力感,意識レベルの低下	脱力感,意識障害
ゆっくりとしか動けない	寡動	行動緩慢
ゆっくり歩ける	歩行障害	歩行障害
ゆれる	ふらつき	めまい
よかんひんにょう	夜間頻尿	夜間頻尿症
よくおしっこに行く	頻尿	多尿,頻尿症
よくわからない	見当識障害	見当識障害
よくわからないが熱がでる	不明熱	不明熱
よく咳が出る	慢性咳嗽	慢性咳嗽
よく喋れん	失語症	失語症
よく聞こえない	構音障害	構音障害
よく見えない	見当識障害	見当識障害
よく見ると血が混じっている尿	顕微鏡的血尿	顕微鏡的血尿
よく飲む	多飲	多飲症
よこはらいたみ	側腹部痛	側腹部痛
よっぱらい	呂律障害,失調性歩行	構音障害,失調性歩行
よぬ飲み込めない	嚥下障害	嚥下障害
よろけ歩行	失調性歩行	失調性歩行
よろつく	ふらつき	めまい
りゅう	粒状陰影	胸部異常陰影
りょうぞう	気管支透亮像	胸部異常陰影
りょうももがはれた	両側下腿浮腫	下腿浮腫
りんぱ	左頚部リンパ節腫脹	頚部リンパ節腫脹
りんぱせつがおおくはれる	多発リンパ節腫脹	リンパ節腫大
りんぱせつひだい	腫大リンパ節	リンパ節腫大
りんぱのしゅようがおおきい	腫大リンパ節	リンパ節腫大
ろう	失語	失語症
ろうあ	構音障害	構音障害
ろうさくじいきぎれ	労作時息切れ	息切れ
ろうどうさぎょうじにいきがくるしくなった	労作時呼吸困難	労作時呼吸困難
ろうどうちゅうにいきがくるしくなる	労作時呼吸困難感	労作時呼吸困難
ろれつがおかしい	呂律障害,呂律困難	構音障害
ろれつがまわらない	呂律困難,呂律障害	構音障害
ろれつがまわらなくなる	呂律不良	不明瞭言語
ろれつが回ってない	構音障害	構音障害
ろれつが回らず言葉が不明瞭なこと	呂律不良	不明瞭言語
ろれつが回らない	呂律障害,呂律困難,呂律不良	構音障害,不明瞭言語
ろれつが回らなくうまくしゃべれない	構語障害	構語障害
ろれつが回らん	呂律困難	構音障害
わからない	褐色尿,嚥下痛	ビリルビン尿,嚥下痛
わからない熱	不明熱	不明熱
わき腹がいたい	左下腹部痛	下腹痛,臍下部痛
わき腹が疼く	左側腹部痛	側腹部痛
わき腹が痛い	側腹部痛,左側腹部痛,右側腹部痛,右下腹部痛	側腹部痛,下腹痛,腸仙痛
わき腹が痛む	左上腹部痛	上腹部痛
わき腹の痛み	左側腹部痛	側腹部痛
わき腹痛	右季肋部痛,側腹部痛,左側腹部痛	季肋部痛,側腹部痛
わしぇだ	記憶障害,物忘れ	記憶障害,健忘症
わずかな血尿	顕微鏡的血尿	顕微鏡的血尿
アカタン	皮下出血	皮下出血
アカフケが落ちる	落屑	鱗屑
アザ	出血斑,圧痕浮腫	斑状出血,浮腫
アシドース	高乳酸血症	高乳酸血症
アトピー	発疹,皮疹	発疹
アトピー性皮膚炎	高ＩｇＥ血症	高ＩｇＥ血症
アナフィラキシーショック	全身性炎症反応症候群	全身性炎症反応症候群
アフタ性口内炎	周期性発熱	発熱
アミラーゼが高い血	高アミラーゼ血症	高アミラーゼ血症
アミラーゼという消化酵素が過多である症状	高アミラーゼ血症	高アミラーゼ血症
アミラーゼの数値が高すぎる	高アミラーゼ血症	高アミラーゼ血症
アルカリフォスファターゼという酵素が血液中に多く含まれる症状	高ＡＬＰ血症	高アルカリホスファターゼ血症
アルカリフォスファターゼ（ALP）活性値がが肝胆道系疾患や骨疾患などで上昇すること	高ＡＬＰ血症	高アルカリホスファターゼ血症
アルツハイマー	物忘れ	健忘症
アル中	肝機能異常,多飲	肝機能検査異常,多飲症
アレルギー	高ＩｇＧ血症,高ＩｇＧ４血症,全身性炎症反応症候群,発疹	高ＩｇＧ血症,ＩｇＧ４関連疾患,高ＩｇＧ血症,全身性炎症反応症候群,発疹
アレルギー疾患	高ＩｇＥ血症	高ＩｇＥ血症
イガイガする	咳嗽	咳
イボ	浮腫	浮腫
ウイルスなどの抗原に対して、リンパ球が生産した抗体の量が上昇すること	抗体価上昇	抗体価上昇
エアブロンコグラム	気管支透亮像	胸部異常陰影
エコー	心陰影拡大	胸部異常陰影
エコーに反応しないコブ	低エコー腫瘤	腫瘤
エコー検査で画像上黒い画像を呈するできもの	低エコー腫瘤	腫瘤
エデム	浮腫	浮腫
エヘン虫	咳	咳
オシ	構語障害	構語障害
オシッコがでにくい	排尿困難	排尿困難
オシッコがまったく出ない	無尿状態	無尿
オシッコがマメにでる	頻尿	多尿,頻尿症
オシッコが出しづらい	排尿困難	排尿困難
オシッコが出し難い	排尿障害	排尿障害
オシッコが出にくい	排尿障害,排尿困難	排尿障害,排尿困難
オシッコが近い	頻尿	多尿,頻尿症
オシッコに血が混じる	尿潜血	顕微鏡的血尿
オシッコの時の痛み	排尿時痛	排尿痛
オシッコ出ない	無尿状態	無尿
オデキ	頚部腫脹	頚部腫脹
カゲ	心陰影	胸部異常陰影
カサブタ	痂皮,落屑	痂皮,鱗屑
カチカチ	こわばり	こわばり
カラ咳	乾性咳	乾性咳
カロリーの消費が間に合わない	体重増加	体重増加
カーッペて口から出るもの	痰	喀痰
ガスだまり	腹満	腹部膨満
ガス充満	腹部膨満	腹部膨満
ガス溜	膨満	腹部膨満
ガタガタと手足の屈伸を繰り返すように動かす間代性痙攣	強直性痙攣	強直性痙攣
ガラスのように影が出ている	スリガラス様陰影	胸部異常陰影
ガン	腫瘤病変,腹部リンパ節腫大,ＣＥＡ高値,全身リンパ節腫大,頚部リンパ節腫脹,多発性腫瘤,全身性リンパ節腫脹,浮腫性変化,腫瘍性病変	腫瘤,リンパ節腫大,ＣＥＡ高値,頚部リンパ節腫脹,リンパ節症,浮腫,-1
ガンからくる痛み	癌性疼痛	癌性疼痛
ガンで痛みがある	癌性疼痛	癌性疼痛
ガンによるズキズキ痛	癌性疼痛	癌性疼痛
ガンに伴って腹に水がたまる	難治性腹水	難治性腹水
ガンの一種	左下肢腫脹,粘膜浮腫	下肢腫脹,浮腫
ガンの影響の痛み	癌性疼痛	癌性疼痛
ガングリ	腫瘍性病変	-1
ガングリオン	皮下結節　,腫瘤形成	腫瘤
ガン化	浮腫状変化	浮腫
クインケ浮腫	腸管浮腫	浮腫
クラクラ	ふらつき,めまい	めまい
クラクラする	眩暈,めまい,ふらつき,めまい感	めまい,めまい感
クレアチンキナーゼが正常値より上昇している	高ＣＫ血症	高クレアチンキナーゼ血症
クレアチンキナーゼが正常値より上昇している状態	高ＣＫ血症	高クレアチンキナーゼ血症
ゲボ	嘔吐	嘔吐症
ゲボをはいた	嘔吐	嘔吐症
ゲロ	嘔吐,嘔気嘔吐,吐き気,痰	嘔吐症,嘔気,嘔吐症,嘔気,喀痰
ゲロが出そう	嘔気	嘔気
ゲロが出る	嘔吐	嘔吐症
ゲロる	嘔吐	嘔吐症
ゲロを吐く	嘔吐	嘔吐症
ゲロゲロ	嘔気嘔吐	嘔気,嘔吐症
ゲロ痛	嚥下痛	嚥下痛
コブ	腫瘤,嚢胞性腫瘤,皮下結節　,頚部腫瘤,皮下腫瘤,巨大腫瘤	腫瘤,頚部腫瘤,皮下腫瘤
コブができる	腫瘤形成	腫瘤
コブが形成される	腫瘤形成	腫瘤
コブの映像	腫瘤像	腫瘤
コブ状のできもの	腫瘤	腫瘤
コミュニケーション障害	運動性失語	運動性失語症
コレステロールが高い	高LDH血症	
コンコン	咳	咳
コンコンする	咳	咳
コンコン出る	咳	咳
ゴホゴホと出る	咳	咳
ゴーンと痛い	鈍痛	鈍痛
サドンデス	突然死	突然死
シェーグレン	抗体価上昇	抗体価上昇
シコリ	リンパ節腫大,皮下結節　,リンパ節腫脹	リンパ節腫大
シコリができる	腫瘤形成	腫瘤
シコリの映像所見	腫瘤像	腫瘤
シミ	皮下出血斑,浮腫	皮下出血,浮腫
ショック	痛み,循環不全,末梢循環不全,意識レベル低下	疼痛,急性循環不全,末梢循環不全,末梢循環不全,意識障害
ショック性言語失	失語症	失語症
ショック状態	多臓器不全	多臓器不全
ションベンに血が混じっている	血尿	血尿
ションベンをすると痛い	排尿時痛	排尿痛
ジストロフィー	四肢筋力低下	四肢筋力低下
ジンジンしている感じ	痺れ感	しびれ感
ジンジンする	しびれ感,しびれ,疼痛,痺れ感,痺れ	しびれ感,疼痛
ジーンとする	鈍痛	鈍痛
ジーンとなる感じ	痺れ感	しびれ感
ストレス	労作時呼吸困難感,下腹部痛,疲労感	労作時呼吸困難,下腹痛,疲労感
ストレス障害	物忘れ	健忘症
スパズムspasm	けいれん	痙攣
スポンジのような感覚	温痛覚低下	知覚鈍麻
スリガラスの影	スリガラス影	胸部異常陰影
スリガラス影	スリガラス影	胸部異常陰影
スリガラス状影	スリガラス状陰影	胸部異常陰影
スリガラス陰影	スリガラス影	胸部異常陰影
ズキズキ	痛み	疼痛
ズキズキした頭痛	拍動性頭痛	頭痛
ズキズキする	痛み,疼痛,頭痛,鈍痛	疼痛,頭痛,鈍痛
ズキズキする痛み	疼痛,拍動性頭痛	疼痛,頭痛
ズキズキする頭痛	拍動性頭痛	頭痛
ズキズキと脈打つ頭痛	拍動性頭痛	頭痛
ズキズキやめる　	疼痛	疼痛
ズキズキ痛いから	鈍痛	鈍痛
ズキズキ痛む	疼痛	疼痛
ズキズキ頭痛	拍動性頭痛	頭痛
ズキンズキンする頭痛	拍動性頭痛	頭痛
ズキンズキンと脈打つような頭痛	拍動性頭痛	頭痛
セキ	咳嗽	咳
ゼイゼイ	喘鳴	喘鳴
ゼイゼイした息	喘鳴	喘鳴
ゼイゼイしている	喘鳴	喘鳴
ゼイゼイする	喘鳴,労作時息切れ	喘鳴,息切れ
ゼエゼエ	喘鳴	喘鳴
ゼロゼロする	喘鳴	喘鳴
ゼーゼー	喘鳴	喘鳴
ゼーゼーいう	喘鳴	喘鳴
ゼーゼーする	喘鳴	喘鳴
ゼーゼーヒューヒュー音	喘鳴	喘鳴
ゾクゾクする	悪寒戦慄	悪寒戦慄
ゾクゾクする寒気	悪寒戦慄	悪寒戦慄
タン	膿性痰,喀痰	膿性痰,喀痰
タンに血が混じる	血痰	血痰
タンパクがおかしい	蛋白細胞解離	髄液蛋白細胞数解離
タンパクが多い尿	高度蛋白尿	蛋白尿
タンパクが尿から沢山出ている	高度蛋白尿	蛋白尿
タンパク尿	尿蛋白	蛋白尿
タンパク量の低下	低補体血症	低補体血症
タールなうんこ	タール便	黒色便
タール便	黒色便	黒色便
タール状のうんち	タール便	黒色便
タール状の便	タール便	黒色便
タール状態の便	タール便	黒色便
ダイエット	体重減少,摂食不良	体重減少,摂食機能障害
ダルい	倦怠感,脱力感,全身倦怠感	倦怠感,脱力感,全身倦怠感
ダルさ	全身倦怠感	全身倦怠感
チアノーゼ	黄染	黄疸
チクチク	痛み	疼痛
チクチクする	痛み	疼痛
チクチクする痛み	疼痛	疼痛
チック	異常行動	異常行動
チリチリした呼吸音	ｆｉｎｅ　ｃｒａｃｋｌｅｓ	湿性ラ音
チーズ壊死	乾酪壊死	壊死
ヅキヅキ	疼痛	疼痛
デキモノ	腫瘤形成,皮下腫瘤,巨大腫瘤,腫瘤	腫瘤,皮下腫瘤
デブ	体重増加,腹部膨満	体重増加,腹部膨満
デブる	体重増加	体重増加
トイレが近い	頻尿,夜間頻尿,多尿,排尿障害	多尿,頻尿症,夜間頻尿症,多尿,排尿障害
トイレが近くて何度も夜に目が覚める	夜間頻尿	夜間頻尿症
トイレが長い	多尿	多尿
トイレちかい	夜間頻尿	夜間頻尿症
トイレに行く回数が多く寝ていても目が覚めてしまう	夜間頻尿	夜間頻尿症
トイレ作業が困難	排尿困難	排尿困難
ドキドキ	動悸発作,動悸,頻拍,頻脈	動悸,頻拍症,頻脈症,洞頻脈
ドキドキする	動悸,動悸発作,頻脈	動悸,頻脈症,洞頻脈
ドキドキ痛い頭痛	拍動性頭痛	頭痛
ドキンドキン	拍動性頭痛	頭痛
ドライマウス	口渇,口渇感	口渇症
ドロッとしたウンコ	タール便	黒色便
ナショナリズム	閉塞性換気障害,頚部リンパ節腫大,腫大リンパ節,高ＣＰＫ血症,腹痛発作	閉塞性換気障害,頚部リンパ節腫脹,リンパ節腫大,高クレアチンキナーゼ血症,腹痛症
ナショナル	高アミラーゼ血症	高アミラーゼ血症
ニキビ	紅色丘疹,硬結	紅色丘疹,硬結
ニョウロ	排尿時痛	排尿痛
ネクローシス	壊死	壊死
ネフローゼ症候群	むくみ,圧痕浮腫	浮腫
ノド荒れ	嚥下痛	嚥下痛
ハアハアする	息切れ	息切れ
ハライタ	腹痛発作	腹痛症
バイタルサイン	意識レベルの低下	意識障害
バセドー	頚部腫脹,頚部腫瘤	頚部腫脹,頚部腫瘤
バタバタする	けいれん発作	てんかん様発作,痙攣発作,痙攣重積発作,全身痙攣発作
バチスタ	心陰影	胸部異常陰影
バランス失調	吐気	嘔気
バランス障害	姿勢反射障害	姿勢異常
パニック	意識混濁	意識混濁
パニック障害	動悸発作	動悸
パンパン	むくみ	浮腫
パンパンに張ってる	むくみ	浮腫
パーキンソン	安静時振戦,失調性歩行	静止時振戦,失調性歩行
パーキンソン病	寡動,安静時振戦	行動緩慢,静止時振戦
ヒューヒューいう	喘鳴	喘鳴
ヒュー音	喘鳴	喘鳴
ヒーヒー	喘鳴	喘鳴
ビクビク	けいれん	痙攣
ビクビクする	けいれん発作,けいれん	てんかん様発作,痙攣発作,痙攣重積発作,全身痙攣発作,痙攣
ビリつき	しびれ	しびれ感
ビリビリ	しびれ感,痺れ感,しびれ	しびれ感
ビリビリした感じ	しびれ感	しびれ感
ビリビリする	しびれ,痺れ感,痺れ,しびれ感	しびれ感
ビリビリすること	痺れ感	しびれ感
ビリビリする感じ	痺れ感	しびれ感
ビリビリ感	痺れ,痺れ感	しびれ感
ビリルビンが高い	高ビリルビン血症	高ビリルビン血症
ビリルビン濃度が高い	高ビリルビン血症	高ビリルビン血症
ビリルピンが高い	高ビリルビン血症	高ビリルビン血症
ビルビリンが高い状態	高ビリルビン血症	高ビリルビン血症
ビンタがいてぇ	頭重感	頭重感
ピクピク	けいれん発作,けいれん	てんかん様発作,痙攣発作,痙攣重積発作,全身痙攣発作,痙攣
ピクピクする	けいれん,痙攣発作,痙攣	痙攣,痙攣発作
ピリピリ	痺れ	しびれ感
ピリピリする	しびれ,痺れ	しびれ感
ピリピリする感じ	痺れ感	しびれ感
ピリピリとしびれている	痺れ感	しびれ感
ピリピリ感ジンジン感を伴う感覚	しびれ	しびれ感
フィーバー	微熱,発熱	微熱,発熱
フケ	落屑	鱗屑
フラフラ	浮動性めまい	めまい
フラフラする	ふらつき,めまい感,眩暈,意識障害	めまい,めまい感,意識障害
フラフラするがよ	眩暈	めまい
フラフラまたはクラクラする	めまい感	めまい感
フラフラ感	めまい感	めまい感
フワフワする	ふらつき	めまい
フワフワめまい	浮動性めまい	めまい
ブツブツ	発疹,皮疹	発疹
ブツブツ出る	発疹	発疹
ブラックアウト	眼前暗黒感	眼前暗黒
ブルブルしとる	けいれん	痙攣
ブルブル震える	悪寒戦慄	悪寒戦慄
ブローカー失語	運動性失語	運動性失語症
ブローカ失語	運動性失語	運動性失語症
ヘルペス	紅色丘疹	紅色丘疹
ヘンコ	異常行動	異常行動
ボケ	物忘れ,記憶障害,見当識障害,感覚障害	健忘症,記憶障害,見当識障害,体感異常
ボケとる	物忘れ	健忘症
ボケる	記憶障害,見当識障害,物忘れ	記憶障害,見当識障害,健忘症
ポックリ死ぬ	突然死	突然死
ポックリ病	突然死	突然死
ポッコリお腹	腹部膨隆	腹部膨満
ポツポツ	皮疹	発疹
ポリープ	腫瘍性病変,肺腫瘤	-1,肺腫瘤
マヒ	感覚障害,しびれ,感覚鈍麻	体感異常,しびれ感,感覚異常症
マヒで呼吸できない	呼吸筋麻痺	呼吸麻痺
マロリーワイス	嚥下痛,心窩部痛	嚥下痛,心窩部痛
ミオクロネース	不随意運動	不随意運動症
ミミズ腫れ	圧痕浮腫	浮腫
ムカムカ	胸部不快感,嘔気	胸部不快感,嘔気
ムカムカして吐いてしまう症状	悪心嘔吐	悪心,嘔吐症
ムカムカして気持ち悪い	嘔気嘔吐,吐き気	嘔気,嘔吐症,嘔気
ムカムカする	嘔気,悪心,嘔吐,上腹部不快感	嘔気,悪心,嘔吐症,腹部不快感
ムンプス	耳下腺腫脹	耳下腺腫脹
メタボリック	腹部膨満,体重増加	腹部膨満,体重増加
メタボリックシンドローム	体重増加	体重増加
メニエル	めまい感	めまい感
メニエール	眩暈	めまい
モドス	吐気	嘔気
モヤモヤした影	スリガラス影	胸部異常陰影
モヤモヤする	上腹部不快感	腹部不快感
モヤモヤ感	胸部不快感	胸部不快感
ヨロヨロする	ふらつき	めまい
ラの音が発音しづらい	湿性ラ音	湿性ラ音
ラリってる	呂律困難	構音障害
リウマチ	こわばり	こわばり
リウマトイド結節	皮下結節　	
リバース	嘔吐	嘔吐症
リンパがえらい腫れる	多発リンパ節腫脹	リンパ節腫大
リンパが大きくはれる	腫大リンパ節	リンパ節腫大
リンパが晴れる	両側肺門リンパ節腫脹,リンパ節腫脹	両側肺門リンパ節腫脹,リンパ節腫大
リンパが肥大	腫大リンパ節	リンパ節腫大
リンパが腫れた	リンパ節腫大,リンパ節腫脹	リンパ節腫大
リンパが腫れている	リンパ節腫脹	リンパ節腫大
リンパが腫れて大きくなる	リンパ節腫脹	リンパ節腫大
リンパが腫れとる	表在リンパ節腫脹,縦隔リンパ節腫脹	リンパ節腫大,縦隔リンパ節腫脹
リンパが腫れる	リンパ節腫大,リンパ節腫脹,縦隔リンパ節腫大,縦隔リンパ節腫脹,全身リンパ節腫脹,腫大リンパ節	リンパ節腫大,縦隔リンパ節腫脹
リンパせつがはれた	リンパ節腫大	リンパ節腫大
リンパせんがはれた	リンパ節腫脹	リンパ節腫大
リンパにできたガン	リンパ節腫大	リンパ節腫大
リンパのできもの大きくなる	縦隔リンパ節腫大	縦隔リンパ節腫脹
リンパのはれ	リンパ節腫脹	リンパ節腫大
リンパの以上	腫大リンパ節	リンパ節腫大
リンパの異常	縦隔リンパ節腫脹,両側肺門リンパ節腫脹,頚部リンパ節腫脹,腫大リンパ節	縦隔リンパ節腫脹,両側肺門リンパ節腫脹,頚部リンパ節腫脹,リンパ節腫大
リンパの病気沢山起きる	多発リンパ節腫大	リンパ節腫大
リンパの腫れ	多発リンパ節腫脹,リンパ節腫大,リンパ節腫脹,傍大動脈リンパ節腫大,表在リンパ節腫脹,全身リンパ節腫大,全身性リンパ節腫脹,頚部リンパ節腫脹	リンパ節腫大,リンパ節症,頚部リンパ節腫脹
リンパの腫物	腫大リンパ節	リンパ節腫大
リンパはれ	肺門リンパ節腫大	肺門リンパ節腫脹
リンパ異常	腹部リンパ節腫大,表在リンパ節腫脹,多発リンパ節腫脹	リンパ節腫大
リンパ節がおおくはれた	多発リンパ節腫大	リンパ節腫大
リンパ節が多数肥大すること	多発リンパ節腫大	リンパ節腫大
リンパ節が大きくなっている	リンパ節腫大	リンパ節腫大
リンパ節が腫れている	リンパ節腫大,リンパ節腫脹,腫大リンパ節	リンパ節腫大
リンパ節が腫れている状態	リンパ節腫脹	リンパ節腫大
リンパ節が腫れて大きくなる	腫大リンパ節	リンパ節腫大
リンパ節が腫れる	リンパ節腫大,リンパ節腫脹,多発リンパ節腫脹	リンパ節腫大
リンパ節が腫大すること	リンパ節腫大	リンパ節腫大
リンパ節が腫瘍すること	リンパ節腫脹	リンパ節腫大
リンパ節が膨らむこと	腹腔内リンパ節腫脹	リンパ節腫大
リンパ節が膨らんでいる	腫大リンパ節	リンパ節腫大
リンパ節が色々な部分で腫れる	多発リンパ節腫脹	リンパ節腫大
リンパ節のはれ	リンパ節腫脹	リンパ節腫大
リンパ節の大きいはれ	リンパ節腫大	リンパ節腫大
リンパ節の大きな腫れ	リンパ節腫大	リンパ節腫大
リンパ節の肥大が複数見られること	多発リンパ節腫大	リンパ節腫大
リンパ節の腫れ	リンパ節腫脹,腫大リンパ節,表在リンパ節腫脹,傍大動脈リンパ節腫大,多発リンパ節腫脹,リンパ節腫大	リンパ節腫大
リンパ節の腫れがたくさんある状態	多発リンパ節腫脹	リンパ節腫大
リンパ節の腫れ物	両側肺門リンパ節腫脹,表在リンパ節腫脹,腫大リンパ節	両側肺門リンパ節腫脹,リンパ節腫大
リンパ節の腫瘍	リンパ節腫大	リンパ節腫大
リンパ節の腫瘍が拡張する	全身性リンパ節腫脹	リンパ節症
リンパ節ガン	縦隔リンパ節腫大	縦隔リンパ節腫脹
リンパ節癌	頚部リンパ節腫脹,リンパ節腫大	頚部リンパ節腫脹,リンパ節腫大
リンパ節腫大	全身性リンパ節腫脹,腫大リンパ節	リンパ節症,リンパ節腫大
リンパ節腫張	腫大リンパ節	リンパ節腫大
リンパ節腫脹	肺門リンパ節腫大,全身リンパ節腫大,腫大リンパ節	肺門リンパ節腫脹,リンパ節腫大
リンパ腫	腫大リンパ節,肺門リンパ節腫大,皮下結節　,縦隔リンパ節腫脹,全身リンパ節腫大,両側肺門部リンパ節腫脹,全身性リンパ節腫脹,腹部リンパ節腫大,耳下腺腫脹,左頚部リンパ節腫脹,頚部リンパ節腫脹,頚部腫瘤,リンパ節腫脹	リンパ節腫大,肺門リンパ節腫脹,縦隔リンパ節腫脹,リンパ節症,耳下腺腫脹,頚部リンパ節腫脹,頚部腫瘤
リンパ腫の一種	両側肺門リンパ節腫脹,表在リンパ節腫脹,多発リンパ節腫脹,腹腔内リンパ節腫大,腹腔内リンパ節腫脹,多発リンパ節腫大	両側肺門リンパ節腫脹,リンパ節腫大
リンパ腺が腫れている	縦隔リンパ節腫脹,表在リンパ節腫脹,多発リンパ節腫大,多発リンパ節腫脹,縦隔リンパ節腫大,腫大リンパ節	縦隔リンパ節腫脹,リンパ節腫大
リンパ腺の腫れ	リンパ節腫大,リンパ節腫脹	リンパ節腫大
レントゲン	胸部異常影,心陰影,びまん性粒状影,スリガラス陰影,線状影,気管支透亮像	胸部異常陰影
レントゲンでちょっと影が見える	スリガラス状陰影	胸部異常陰影
レントゲンで変な影	スリガラス陰影	胸部異常陰影
レントゲンで穴が開いたようにみえる影	空洞影	胸部異常陰影
レントゲンで空洞映っている	空洞影	胸部異常陰影
レントゲンで粒のような影が映る	粒状陰影	胸部異常陰影
レントゲンで肺に影が出る	肺浸潤影	肺部異常陰影
レントゲンで胸にうつった影	胸部異常影	胸部異常陰影
レントゲンで胸に影がある	胸部異常陰影	胸部異常陰影
レントゲンで胸に影ができてしまう	胸部異常陰影	胸部異常陰影
レントゲンで腺のような影がうつる	線状影	胸部異常陰影
レントゲンなどで胸のあたりに影ができている	胸部異常影	胸部異常陰影
レントゲンなどの異常な影	胸部異常影	胸部異常陰影
レントゲンに影がある	胸部異常陰影	胸部異常陰影
レントゲンに映る広く広がる粒状の影	びまん性粒状影	胸部異常陰影
レントゲンに映る気管支が黒く見える	気管支透亮像	胸部異常陰影
レントゲン画像に影が写る	スリガラス影	胸部異常陰影
レントゲン異常	胸部異常陰影,心電図異常	胸部異常陰影,心電図異常
レントゲン等ですりガラスのようにぼやけて映った部分	スリガラス状陰影	胸部異常陰影
ロレツが悪い	呂律障害	構音障害
一人で歩けない	歩行障害	歩行障害
一回に出る尿が多い	多尿	多尿
一度にたくさん血が出て止まらない	大量出血	多量出血
一日の体温差が1℃以上の変化をとること	弛張熱	弛張熱
一時的な意識のもうろう	一過性意識障害	一過性意識障害
一時的な意識の乱れ	一過性意識障害	一過性意識障害
一時的な意識不明	一過性意識障害	一過性意識障害
一時的に意識がない	一過性意識障害	一過性意識障害
一時的に意識がなくなる	一過性意識障害	一過性意識障害
一時的に曖昧	一過性意識障害	一過性意識障害
一時的に気を失う	一過性意識障害	一過性意識障害
一酸化炭素中毒	高炭酸ガス血症,低酸素血症	高炭酸ガス血症,低酸素血症
上の腹が痛い	上腹部痛	上腹部痛
上半身の触れる事ができるリンパ節の腫れ	表在リンパ節腫脹	リンパ節腫大
上半身を起こして呼吸をする	起坐呼吸	起坐呼吸
上手くしゃべれない	構語障害,呂律困難	構語障害,構音障害
上手くしゃべれん	呂律困難	構音障害
上手く呼吸ができない	呼吸困難	呼吸困難
上手く歩けない	歩行困難,歩行障害	歩行困難,歩行障害
上手く歩けん	失調性歩行	失調性歩行
上手く発音できない	構音障害	構音障害
上手く話せない	構語障害,呂律障害,呂律不良,呂律困難	構語障害,構音障害,不明瞭言語
上手く飲み込めない	嚥下機能障害,嚥下障害	嚥下協調障害,嚥下障害,嚥下障害
上手に食べ物を飲み込めないこと	嚥下障害	嚥下障害
上腹部が痛い	上腹部痛	上腹部痛
上腹部の痛み	心窩部痛	心窩部痛
上腹部の違和感	上腹部不快感	腹部不快感
上腹部疼痛	上腹部痛	上腹部痛
上腹部痛	上腹部痛	上腹部痛
上腹部重圧感	心窩部不快感	心窩部不快
下っ腹が痛い	下腹部痛,左下腹部痛	下腹痛,下腹痛,臍下部痛
下っ腹痛	左下腹部痛	下腹痛,臍下部痛
下に出るできもの	下肢浮腫	下肢浮腫
下ばらが痛い	下腹部痛	下腹痛
下半身がうずく	下肢疼痛	疼痛
下半身がだるい	下肢脱力	下肢脱力感
下半身がむくむ	下肢浮腫	下肢浮腫
下半身が動きづらい	下肢脱力感	下肢脱力感
下半身が痛い	下肢疼痛	疼痛
下半身が痛むこと	下肢疼痛	疼痛
下半身に力が入らない	下肢脱力感,下肢脱力	下肢脱力感
下半身のだるさ	下肢脱力感	下肢脱力感
下半身のむくみ	下腿浮腫,下肢浮腫	下腿浮腫,下肢浮腫
下半身の力が入らない	下肢脱力	下肢脱力感
下半身の力が抜ける	四肢脱力	四肢脱力
下半身の浮腫	下腿浮腫	下腿浮腫
下半身の痛み	下肢疼痛	疼痛
下半身デブ	下腿浮腫	下腿浮腫
下半身脱力感	下肢脱力感	下肢脱力感
下痢	腹部不快感,腹痛,嘔吐	腹部不快感,腹痛症,腹壁痛,仙痛,嘔吐症
下痢便	タール便	黒色便
下痢痛	下腹部痛	下腹痛
下肢にしびれや痛みあるいは脱力感が現れること	下肢脱力感	下肢脱力感
下肢に力が入らない	下肢脱力感	下肢脱力感
下肢のむくみ	下肢浮腫,下腿浮腫	下肢浮腫,下腿浮腫
下肢の水膨れ	下腿浮腫	下腿浮腫
下肢の腫れ	両下腿浮腫	下腿浮腫
下肢の膨張	下肢浮腫	下肢浮腫
下肢倦怠感	下肢脱力感	下肢脱力感
下肢力が入らない	下肢脱力感	下肢脱力感
下肢動脈瘤	左下肢腫脹	下肢腫脹
下肢浮腫	下腿浮腫,下肢浮腫	下腿浮腫,下肢浮腫
下肢瘤	下肢浮腫	下肢浮腫
下肢障害	歩行障害	歩行障害
下肢静脈瘤	下肢疼痛	疼痛
下腹が痛い	下腹部痛	下腹痛
下腹の痛み	下腹部痛	下腹痛
下腹部が痛い	下腹部痛	下腹痛
下腹部の痛み	下腹部痛	下腹痛
下腹部疼痛	下腹部痛	下腹痛
下腹部痛	下腹部痛,左下腹部痛	下腹痛,下腹痛,臍下部痛
下腿 に初発 した悪性 リンパ腫	左下腿腫脹	下腿腫脹
下足にしこり	下腿浮腫	下腿浮腫
不安定な歩行	失調性歩行	失調性歩行
不振	歩行困難,歩行障害,嚥下障害,食欲低下	歩行困難,歩行障害,嚥下障害,食欲不振
不整脈	徐脈,心電図異常,徐脈性不整脈,高度徐脈,頻拍,頻脈性不整脈,頻脈,心雑音,心窩部不快感,血管雑音,房室回帰性頻拍,洞性徐脈,動悸発作,動悸	徐脈,心電図異常,徐脈性不整脈,頻拍症,頻脈性不整脈,頻脈症,洞頻脈,心雑音,心窩部不快,動脈性雑音,洞徐脈,動悸
不整脈にゆっくりなる	徐脈性不整脈	徐脈性不整脈
不整脈のひどいもの	高度徐脈	徐脈
不明	喀血	喀血
不明熱	不明熱	不明熱
不正出血	性器出血	性器出血
不正脈	心電図異常,頻脈性不整脈,徐脈	心電図異常,頻脈性不整脈,徐脈
不随意的行為	不随意運動	不随意運動症
不随意運動	不随意運動	不随意運動症
不静脈	血管雑音,心雑音	動脈性雑音,心雑音
不食	食欲不振	食欲不振
丘疹や結節腫瘤内容物として水分を含む水疱や角化物などを含む腫	紅色丘疹	紅色丘疹
両はいのりんぱがはれた	両側肺門リンパ節腫脹	両側肺門リンパ節腫脹
両下肢むくみ	両下肢浮腫	下肢浮腫
両下肢浮腫	両下肢浮腫	下肢浮腫
両下腿むくみ	両下腿浮腫	下腿浮腫
両下腿浮腫	両下腿浮腫	下腿浮腫
両側の肺のリンパ節の腫れ	両側肺門部リンパ節腫脹	肺門リンパ節腫脹
両側の肺のリンパ腺の腫れ	両側肺門部リンパ節腫脹	肺門リンパ節腫脹
両側の肺・気管支のリンパ節腫れ	両側肺門リンパ節腫脹	両側肺門リンパ節腫脹
両側肺門部リンパ節腫れ	両側肺門部リンパ節腫脹	肺門リンパ節腫脹
両太ももの膨張	両下腿浮腫	下腿浮腫
両手両脚が浮腫んでいる状態	四肢浮腫	四肢浮腫
両手両脚に力が入らない	四肢脱力感	四肢脱力感
両手両足のむくみ	四肢浮腫	四肢浮腫
両手足に力が入らない	四肢脱力感	四肢脱力感
両手足の力がなくなっていく	四肢筋力低下	四肢筋力低下
両手足の力が抜ける	四肢脱力	四肢脱力
両方のすねに腫れもの	両側下腿浮腫	下腿浮腫
両方の下肢の膨張	両下肢浮腫	下肢浮腫
両方の肺のリンパが腫れた	両側肺門リンパ節腫脹	両側肺門リンパ節腫脹
両方の肺のリンパの腫物	両側肺門部リンパ節腫脹	肺門リンパ節腫脹
両脚のむくみ	両下腿浮腫,両下肢浮腫	下腿浮腫,下肢浮腫
両脚部むくみ	両側下腿浮腫,両下腿浮腫,両下肢浮腫	下腿浮腫,下肢浮腫
両足がむくむ	両下肢浮腫,両側下腿浮腫,両下腿浮腫	下肢浮腫,下腿浮腫
両足がむくんでいる	両側下腿浮腫	下腿浮腫
両足が腫れている	両下腿浮腫,両下肢浮腫	下腿浮腫,下肢浮腫
両足が腫れる	両下腿浮腫,両下肢浮腫	下腿浮腫,下肢浮腫
両足のむくみ	両下腿浮腫,両下肢浮腫,両側下腿浮腫	下腿浮腫,下肢浮腫
両足の側面がむくむ	両側下腿浮腫	下腿浮腫
両足の浮腫み	両側下腿浮腫	下腿浮腫
両足むくみ	両下腿浮腫	下腿浮腫
両足両手に力が入らない	四肢脱力感	四肢脱力感
両足全体がむくんでいる	両下肢浮腫	下肢浮腫
両足浮腫	両側下腿浮腫	下腿浮腫
中度意識混濁	昏迷	昏迷
中度意識障害	昏迷	昏迷
中気	痺れ	しびれ感
中等度意識混濁	昏迷	昏迷
中耳炎	耳下腺腫脹	耳下腺腫脹
丹	喀痰	喀痰
主要	頚部腫脹	頚部腫脹
乏尿	無尿状態,無尿	無尿
乱れた脈が速く打つこと	頻脈性不整脈	頻脈性不整脈
乳がん	充実性腫瘤,腫瘍性病変	腫瘤,-1
乳房のこり	房室回帰性頻拍	頻拍症
乳酸値が高くなった血	高乳酸血症	高乳酸血症
乳酸値が高くなり酸血になる	高乳酸血症	高乳酸血症
乾いたくしゃみ	乾性咳	乾性咳
乾いたせき	乾性咳	乾性咳
乾いた咳	乾性咳,乾性咳嗽	乾性咳
乾いた咳が出る	乾性咳	乾性咳
乾いた咳が続く	乾性咳嗽	乾性咳
乾いた感じの咳	乾性咳	乾性咳
乾いた木を小刻みに割るような細かい喉の違和感	咳	咳
乾き	口渇感	口渇症
乾性咳嗽	乾性咳嗽	乾性咳
乾燥	乾性咳嗽	乾性咳
乾燥した咳	乾性咳	乾性咳
乾燥して咳が出る	乾性咳嗽	乾性咳
乾燥による壊死	乾酪壊死	壊死
二つの肺の入口のリンパ節がはれる	両側肺門部リンパ節腫脹	肺門リンパ節腫脹
二酸化炭素が高い血	高二酸化炭素血症	高炭酸ガス血症
二酸化炭素と麻酔作用	CO２ナルコーシス	
二酸化炭素による看護婦呼ぶセンサー	CO２ナルコーシス	
二酸化炭素の呼吸調節系への麻酔作用	CO２ナルコーシス	
二酸化炭素をうまく排出できない	高炭酸ガス血症	高炭酸ガス血症
二酸化炭素を吸った事で中毒になる	高二酸化炭素血症	高炭酸ガス血症
二酸化炭素中毒	高二酸化炭素血症	高炭酸ガス血症
五十肩	左下腿腫脹	下腿腫脹
五感が正常に働かない	感覚障害	体感異常
今まで持てたものが持てなくなる	筋力低下	筋力低下
今日になくなる	突然死	突然死
仕事中に息切れ	労作時息切れ	息切れ
仕事中に胸が痛む	労作時胸痛	反復性胸痛,胸痛
仕事中の呼吸が苦しい	労作時呼吸困難感	労作時呼吸困難
仕事時に息苦しい	労作時呼吸困難	労作時呼吸困難
代謝	熱	発熱
代謝がよい	発汗過多	多汗症
仰向けだと苦しい	起坐呼吸	起坐呼吸
仰向けで腹が張って盛り上がっている	腹部膨隆	腹部膨満
休んでいても胸が痛い状態	安静時胸痛	反復性胸痛,胸痛
休憩不足	疲労感	疲労感
会話できない	失語症	失語症
会話障害	失語症	失語症
低い熱	微熱	微熱
低い熱が出た	微熱	微熱
低下	記銘力低下	記銘力低下
低体重	体重減少	体重減少
低熱	微熱	微熱
低血圧	低補体血症	低補体血症
低血圧症	低補体血症	低補体血症
低血糖	耐糖能異常	耐糖能異常
低補体血症	低補体血症	低補体血症
低酸素症	チアノーゼ	チアノーゼ
低酸素血症	びまん性粒状影	胸部異常陰影
体から力が抜けてぐったりした感じ	脱力感	脱力感
体がだるい	全身倦怠感,倦怠感,易疲労感	全身倦怠感,倦怠感,易疲労感
体がだるく感じる	倦怠感	倦怠感
体がぴくぴくする	全身性痙攣	全身痙攣
体がふらふらする	ふらつき	めまい
体がほてる	微熱	微熱
体がむくむ	全身性浮腫,全身浮腫	全身性浮腫
体がピクピクする	痙攣,強直性痙攣	痙攣,強直性痙攣
体が全体的にだるいこと	全身倦怠感	全身倦怠感
体が動かない	けいれん発作	てんかん様発作,痙攣発作,痙攣重積発作,全身痙攣発作
体が勝手に動く	不随意運動	不随意運動症
体が勝手に震える	痙攣	痙攣
体が強張るけいれん	強直性痙攣	強直性痙攣
体が思うように動かない	けいれん	痙攣
体が浮腫んでいる腫れている	全身浮腫	全身性浮腫
体が熱い	熱感	ほてり
体が痛い	全身痛	全身痛
体が痺れる	けいれん発作,痙攣発作,けいれん,痙攣	てんかん様発作,痙攣発作,痙攣重積発作,全身痙攣発作,痙攣発作,痙攣
体が硬くなってる	項部硬直	項部硬直
体が細かく震える	けいれん	痙攣
体が腐り始めた	壊死	壊死
体が腫れている	全身性浮腫	全身性浮腫
体が重い	体重増加	体重増加
体が震えている	痙攣	痙攣
体が震える	けいれん,痙攣	痙攣
体にあかいブツブツ	発疹	発疹
体に力がはいらない	脱力	脱力感,筋脱力
体に力が入らない	脱力感	脱力感
体のあちこちに脂肪の塊がある	多発性腫瘤	腫瘤
体のむくみ	全身性浮腫	全身性浮腫
体のバランスが取れない	姿勢反射障害	姿勢異常
体の一部が腐ってる事	壊死	壊死
体の一部分が死んでる	壊死	壊死
体の内部に膨らみができる	腫瘤	腫瘤
体の痙攣	全身性痙攣	全身痙攣
体の痛み	全身痛	全身痛
体の皮下組織や臓器の組織間隙に水分が多量に貯留した状態	浮腫状変化	浮腫
体の筋肉が落ちる	筋力低下	筋力低下
体の細胞組織の一部が死ぬ	壊死	壊死
体の組織でできた二酸化炭素を十分に体外に放出できない	高二酸化炭素血症	高炭酸ガス血症
体の重さが減る	体重減少	体重減少
体の震え	痙攣	痙攣
体の震えが急におこる	痙攣発作	痙攣発作
体や臓器に塊ができていること	腫瘤	腫瘤
体を動かしている時に息切れする	労作時呼吸困難	労作時呼吸困難
体を動かしている時に息苦しい	労作時息切れ	息切れ
体を動かすと呼吸が苦しい	労作時呼吸困難感	労作時呼吸困難
体を動かすと胸が痛い	労作時胸痛	反復性胸痛,胸痛
体中えらい	全身倦怠感	全身倦怠感
体中がだるい	全身倦怠感	全身倦怠感
体中がぴくぴくする	痙攣重積	痙攣重積発作
体中が浮腫む	全身性浮腫	全身性浮腫
体中が痛い	全身痛	全身痛
体中できもの	全身性浮腫	全身性浮腫
体中にできもの	全身浮腫	全身性浮腫
体中のむくみ	全身性浮腫	全身性浮腫
体中のリンパ腺の腫れ	全身リンパ節腫脹	リンパ節腫大
体中の浮腫み	全身浮腫	全身性浮腫
体中の痛み	全身痛	全身痛
体中の節々にグリグリがある状態	全身リンパ節腫脹	リンパ節腫大
体中リンパの異常	全身リンパ節腫脹	リンパ節腫大
体中痛い	全身痛	全身痛
体全体がだるい	四肢脱力感	四肢脱力感
体全体がむくんでる	全身性浮腫	全身性浮腫
体全体がマヒ	全身性痙攣	全身痙攣
体全体が浮腫む	全身浮腫	全身性浮腫
体全体が腫れる	全身性浮腫	全身性浮腫
体全体に腫れがある	全身浮腫	全身性浮腫
体全体の痙攣	全身性痙攣	全身痙攣
体全体の痛み	全身痛	全身痛
体内にできる袋状中に液体がたまったものからの内出血	嚢胞内出血	内出血
体力が低下	筋力低下	筋力低下
体力が落ちる	筋力低下	筋力低下
体力の限界	息切れ	息切れ
体力不足	筋力低下,息切れ	筋力低下,息切れ
体力消耗	虚脱	虚脱
体動時の息苦しさ	労作時呼吸困難	労作時呼吸困難
体温	熱	発熱
体温が37℃以上上がる	熱	発熱
体温がへる	体重減少	体重減少
体温が上がる	発熱	発熱
体温が低いこと	低補体血症	低補体血症
体温が常温以上になること	発熱	発熱
体温が平常より高くなる	熱発	発熱
体温が通常より上がる	熱	発熱
体温が高い	熱発,高熱,熱,発熱	発熱,高熱
体温が高くなった時	高熱	高熱
体温が高くなる	高熱	高熱
体温の上昇	熱	発熱
体温の異常高温	熱発	発熱
体温は変動するけれど平熱には戻らない	弛張熱	弛張熱
体温上昇	熱,高熱,熱感,発熱	発熱,高熱,ほてり
体温高温	熱発	発熱
体重が増えていく	体重増加	体重増加
体重が増える	体重増加	体重増加
体重が減っている	体重減少	体重減少
体重が減る	体重減少	体重減少
体重が落ちる	体重減少	体重減少
体重へった	体重減少	体重減少
体重低下	体重減少	体重減少
体重増加	体重増加	体重増加
体重減少	体重減少	体重減少
体重計の針が壊れるかと思ったほど体がうめく	体重増加	体重増加
何か動くと呼吸がしんどい	労作時呼吸困難	労作時呼吸困難
何か味が変	味覚障害	味覚障害
何で発熱しているのかわからない状態	不明熱	不明熱
何も食べたくない	食欲不振	食欲不振
何らかの原因により呼吸が苦しくなる	呼吸困難	呼吸困難
何をしているのだろう	記憶障害	記憶障害
何回もリンパがはれる	多発リンパ節腫大	リンパ節腫大
何度もお腹が痛くなること	腹痛発作	腹痛症
何度もオシッコが出る	頻尿	多尿,頻尿症
作業・労働時に呼吸が苦しい	労作時息切れ	息切れ
作業中に呼吸ができなくなる	労作時呼吸困難	労作時呼吸困難
作業中の息切れ	労作時息切れ	息切れ
作業時に息が苦しくなる	労作時呼吸困難	労作時呼吸困難
作業時呼吸困難	労作時呼吸困難	労作時呼吸困難
作業時息切れ	労作時息切れ	息切れ
便がべたべたする	タール便	黒色便
便が黒い	黒色便	黒色便
便が黒いよ	黒色便	黒色便
便秘	無尿,腹満感,腹部膨満感,腹部膨満	無尿,腹部膨満
便通が悪い	タール便	黒色便
倒れる	意識消失	意識消失
倦怠	脱力,脱力感	脱力感,筋脱力,脱力感
倦怠感	脱力感,疲労感,易疲労感,脱力,下肢脱力感,四肢脱力感,虚脱,全身痛,四肢脱力	脱力感,疲労感,易疲労感,脱力感,筋脱力,下肢脱力感,四肢脱力感,虚脱,全身痛,四肢脱力
偏頭痛	拍動性頭痛,後頭部痛,頭痛	頭痛,後頭部痛
健忘	物忘れ	健忘症
健忘症	物忘れ,一過性意識障害,意識レベルの低下	健忘症,一過性意識障害,意識障害
側腹部打撲	側腹部痛	側腹部痛
傍大動脈リンパ節の腫れ	傍大動脈リンパ節腫大	リンパ節腫大
傍大動脈リンパ節腫れ	傍大動脈リンパ節腫大	リンパ節腫大
傷	皮下出血	皮下出血
傷がついた皮膚	痂皮	痂皮
傷み	鈍痛	鈍痛
傷口が開く	再出血	出血
働いている時に息をするのが出来なくなること	労作時呼吸困難	労作時呼吸困難
働いている時の呼吸が苦しい	労作時呼吸苦	労作時呼吸困難
元気消失	虚脱	虚脱
全ての臓器が動かなくなる	多臓器不全	多臓器不全
全体的にだるい	全身浮腫	全身性浮腫
全身がいたい	全身痛	全身痛
全身がぐったり	四肢脱力感,下肢脱力感	四肢脱力感,下肢脱力感
全身がしびれる	全身性痙攣	全身痙攣
全身がだるい	全身倦怠感,全身性痙攣	全身倦怠感,全身痙攣
全身がむくむ	全身性浮腫,全身浮腫	全身性浮腫
全身がむくんでいる	全身性浮腫	全身性浮腫
全身がん	全身浮腫	全身性浮腫
全身が怠い	全身倦怠感	全身倦怠感
全身が浮腫む	全身性浮腫,全身浮腫	全身性浮腫
全身が炎症起こしてる感じ	全身性炎症反応症候群	全身性炎症反応症候群
全身が痛い	全身痛	全身痛
全身が硬直またはガタガタして倒れること	強直性痙攣	強直性痙攣
全身が腫れている	全身浮腫	全身性浮腫
全身だるい	全身倦怠感	全身倦怠感
全身で痙攣が起こる	全身性痙攣	全身痙攣
全身にむくみが出る	全身浮腫	全身性浮腫
全身に水ぶくれ	全身性浮腫	全身性浮腫
全身に炎症がある	全身性炎症反応症候群	全身性炎症反応症候群
全身に痙攣が見られた	全身性痙攣	全身痙攣
全身に痙攣が起きている	全身性痙攣	全身痙攣
全身に痛みが走る	全身痛	全身痛
全身に腫れものができる	全身性浮腫	全身性浮腫
全身のだるさ	全身倦怠感	全身倦怠感
全身のむくみ	全身浮腫,全身性浮腫,全身リンパ節腫脹	全身性浮腫,リンパ節腫大
全身のリンパが腫れる	全身リンパ節腫脹	リンパ節腫大
全身のリンパのガン	全身リンパ節腫脹	リンパ節腫大
全身のリンパ節がはれる	全身リンパ節腫脹	リンパ節腫大
全身のリンパ節が腫れている	多発リンパ節腫大	リンパ節腫大
全身のリンパ節が腫れて大きくなっている	全身リンパ節腫大	リンパ節腫大
全身のリンパ節の腫瘍が大きくなる病気	全身リンパ節腫大	リンパ節腫大
全身のリンパ節の腫瘍が拡大する	全身リンパ節腫大	リンパ節腫大
全身のリンパ腺が腫れている	全身リンパ節腫脹	リンパ節腫大
全身の体の痛み	全身痛	全身痛
全身の力が抜ける	虚脱	虚脱
全身の浮腫み	全身性浮腫	全身性浮腫
全身の炎症	全身性炎症反応症候群	全身性炎症反応症候群
全身の疲れ	疲労感	疲労感
全身の疼痛	腫大リンパ節	リンパ節腫大
全身の痙攣	全身性痙攣,痙攣発作	全身痙攣,痙攣発作
全身の痛み	全身痛	全身痛
全身の腫れ	全身浮腫	全身性浮腫
全身または炎症のある局所に感じられる熱	熱感	ほてり
全身まひ	全身性痙攣	全身痙攣
全身むくみ	四肢浮腫,全身性浮腫,全身浮腫	四肢浮腫,全身性浮腫
全身むくんどる	全身性浮腫	全身性浮腫
全身ガン	全身リンパ節腫大	リンパ節腫大
全身マヒ	全身性痙攣	全身痙攣
全身リンパはれ	全身リンパ節腫大	リンパ節腫大
全身リンパガン	全身性リンパ節腫脹	リンパ節症
全身リンパ節腫れ	全身リンパ節腫脹	リンパ節腫大
全身リンパ節腫大	全身性リンパ節腫脹	リンパ節症
全身倦怠感	疲労感	疲労感
全身性の急性炎症反応	全身性炎症反応症候群	全身性炎症反応症候群
全身性むくみ	全身性浮腫	全身性浮腫
全身浮腫	全身浮腫	全身性浮腫
全身状態低下	循環不全	急性循環不全,末梢循環不全
全身疲労	全身倦怠感	全身倦怠感
全身疲労感	全身倦怠感	全身倦怠感
全身痙攣	けいれん発作	てんかん様発作,痙攣発作,痙攣重積発作,全身痙攣発作
全身麻痺	全身性痙攣	全身痙攣
全部のリンパが腫れる	全身リンパ節腫脹	リンパ節腫大
内出血	点状出血,出血斑,皮下出血斑,皮下出血,びまん性粒状影,嚢胞内出血	点状出血,斑状出血,皮下出血,胸部異常陰影,内出血
内出血によるあざ	皮下出血斑	皮下出血
内臓がおかしい	多臓器不全	多臓器不全
内臓がぐちゃぐちゃ	多臓器不全	多臓器不全
内臓が悪い	多臓器障害	多臓器不全
内臓が腫れている	脾腫	脾腫
内臓が軽く腫れること	軽度腫大	リンパ節腫大
内臓ガン	腹腔内腫瘤	腹腔内腫瘤
内臓不全	多臓器障害	多臓器不全
内臓機能不全	多臓器不全	多臓器不全
内部出血	点状出血	点状出血
再び出血	再出血	出血
再び出血が見られること	再出血	出血
再び出血する	再出血	出血
再び血が出る	再出血	出血
再度出血	再出血	出血
冷え性	末梢循環不全,温痛覚低下	末梢循環不全,知覚鈍麻
冷え症	末梢循環不全	末梢循環不全
冷や汗	盗汗	寝汗
冷汗	盗汗	寝汗
凄い汗	発汗過多	多汗症
凝り固まる	固縮	こわばり
凝固壊死	乾酪壊死	壊死
出来物	脾腫,顔面浮腫	脾腫,顔面浮腫
出血	活動性出血,潜血,性器出血,大量出血,再出血	出血,顕微鏡的血尿,性器出血,多量出血
出血が多すぎてショック状態	出血性ショック	出血性ショック
出血したあと	出血斑	斑状出血
出血したばかりの血	潜血	顕微鏡的血尿
出血により体から大量の血液が失われることで全身の臓器障害が引き起こされる状態	出血性ショック	出血性ショック
出血による急激な血圧低下、全身の末梢性循環障害	出血性ショック	出血性ショック
出血多量	出血性ショック,大量出血,活動性出血	出血性ショック,多量出血,出血
出血多量によるショック	出血性ショック	出血性ショック
出血性ショック	循環不全,出血性ショック	急性循環不全,末梢循環不全,出血性ショック
出血性腎嚢胞	嚢胞内出血	内出血
出血量増加	出血性ショック	出血性ショック
分かりません	嘔気嘔吐,腹満感,膵腫大	嘔気,嘔吐症,腹部膨満,膵腫大
刺すような痛み	疼痛	疼痛
刺激を正常に知覚できない状態	知覚障害	知覚障害
前に比べて食べたいと思わなくなった	食欲低下	食欲不振
前傾姿勢	姿勢反射障害	姿勢異常
前胸の部分の圧迫感	前胸部圧迫感	胸部不快感
前胸痛	全胸部痛	
前胸部疼痛	全胸部痛	
前胸部痛	全胸部痛	
前触れなく急に亡くなる	突然死	突然死
前身が痛い	全身痛	全身痛
前部胸痛	全胸部痛	
力がぬける	脱力	脱力感,筋脱力
力がはいらない	脱力,四肢脱力	脱力感,筋脱力,四肢脱力
力がは入らない	虚脱	虚脱
力が上手く入らない	脱力感	脱力感
力が入らない	脱力,筋力低下,脱力感,虚脱,下肢脱力,四肢脱力,四肢脱力感	脱力感,筋脱力,筋力低下,脱力感,虚脱,下肢脱力感,四肢脱力,四肢脱力感
力が入らないこと	脱力	脱力感,筋脱力
力が入らん	脱力,四肢脱力,四肢筋力低下	脱力感,筋脱力,四肢脱力,四肢筋力低下
力が出ない	脱力感	脱力感
力が思うように入らない	筋力低下	筋力低下
力が抜けた	脱力	脱力感,筋脱力
力が抜けた感じ	脱力感	脱力感
力が抜けてる	脱力感	脱力感
力が抜ける	脱力,四肢脱力,下肢脱力,脱力感,虚脱	脱力感,筋脱力,四肢脱力,下肢脱力感,脱力感,虚脱
力が抜ける感覚がする	脱力感	脱力感
力が無くなる	筋力低下	筋力低下
力を抜く	脱力	脱力感,筋脱力
力入らず	脱力感	脱力感
力入らない	ふらつき	めまい
労作	労作時息切れ	息切れ
労作性の呼吸困難	労作時呼吸苦	労作時呼吸困難
労作性呼吸困難	労作時呼吸苦,労作時息切れ	労作時呼吸困難,息切れ
労作時の呼吸 難しい	労作時呼吸困難感	労作時呼吸困難
労作時の息切れ	労作時呼吸苦	労作時呼吸困難
労作時呼吸困難	労作時息切れ,労作時呼吸苦	息切れ,労作時呼吸困難
労作時呼吸苦	労作時呼吸苦	労作時呼吸困難
労作時息切れ	労作時呼吸苦,労作時呼吸困難感,労作時息切れ	労作時呼吸困難,息切れ
労作時胸打撲	労作時胸痛	反復性胸痛,胸痛
労作時腰部疼痛	労作時胸痛	反復性胸痛,胸痛
労働すると呼吸ができない	労作時呼吸困難	労作時呼吸困難
労働・作業時に呼吸が苦しい	労作時呼吸困難	労作時呼吸困難
動いたときの息苦しさ	労作時息切れ	息切れ
動いたら呼吸がしんどい	労作時呼吸苦	労作時呼吸困難
動いたり作業した時に胸が痛む症状	労作時胸痛	反復性胸痛,胸痛
動いた時に呼吸がしにくい	労作時呼吸困難	労作時呼吸困難
動いた時に息をすることが難しい状態	労作時呼吸困難	労作時呼吸困難
動いた時の呼吸苦	労作時呼吸苦	労作時呼吸困難
動いた時息が苦しくなる	労作時呼吸苦	労作時呼吸困難
動いた時息苦しくなる感じ	労作時呼吸困難感	労作時呼吸困難
動いているときに息切れする	労作時息切れ	息切れ
動いている時に出血すること	活動性出血	出血
動いてハアハアする	労作時息切れ	息切れ
動かしている状態で血が出た	活動性出血	出血
動かず横になっている時に胸の痛みがある	安静時胸痛	反復性胸痛,胸痛
動きが悪い	寡動	行動緩慢
動きが遅い	寡動	行動緩慢
動きが鈍い	姿勢反射障害	姿勢異常
動くだけで出血	活動性出血	出血
動くとすぐに疲れる	息切れ	息切れ
動くとはあはあ言う	労作時息切れ	息切れ
動くと出血	活動性出血	出血
動くと呼吸がしづらくなる	労作時息切れ	息切れ
動くと呼吸が苦しい	労作時呼吸困難	労作時呼吸困難
動くと息ができない	労作時呼吸困難,労作時呼吸困難感	労作時呼吸困難
動くと息が出来ない	労作時息切れ	息切れ
動くと息が出来ない感じ	労作時呼吸困難感	労作時呼吸困難
動くと息が苦しい	労作性呼吸困難,労作時呼吸困難,労作時呼吸困難感,労作時息切れ	発作性呼吸困難,労作時呼吸困難,労作時呼吸困難,息切れ
動くと息が苦しくなる感じがする	労作時呼吸困難感	労作時呼吸困難
動くと息切れがする	労作時呼吸苦	労作時呼吸困難
動くと息切れする	労作時呼吸苦,労作時息切れ	労作時呼吸困難,息切れ
動くと息苦しい	労作時呼吸苦,労作時呼吸困難感,労作時呼吸困難,労作時息切れ	労作時呼吸困難,息切れ
動くと胸が痛い	労作時胸痛	反復性胸痛,胸痛
動くと胸が痛くなる	労作時胸痛	反復性胸痛,胸痛
動くと苦しい	労作時呼吸苦,労作時呼吸困難	労作時呼吸困難
動く時に呼吸が出来なくなる	労作時呼吸困難	労作時呼吸困難
動く時に息切れする	労作時呼吸困難感	労作時呼吸困難
動く時に胸が痛む	労作時胸痛	反復性胸痛,胸痛
動作で胸が痛い	労作時胸痛	反復性胸痛,胸痛
動作出血	活動性出血	出血
動作時に呼吸が苦しくなる	労作性呼吸困難	発作性呼吸困難,労作時呼吸困難
動悸	息切れ,労作時息切れ,動悸発作,頻脈性不整脈,頻脈,血管雑音,房室回帰性頻拍,労作時胸痛,徐脈性不整脈,呼吸困難,心雑音,前胸部圧迫感,呼吸苦,労作時呼吸困難,呼吸困難感	息切れ,動悸,頻脈性不整脈,頻脈症,洞頻脈,動脈性雑音,頻拍症,反復性胸痛,胸痛,徐脈性不整脈,呼吸困難,心雑音,胸部不快感,呼吸促迫,呼吸困難,労作時呼吸困難,呼吸麻痺
動悸がある	動悸発作	動悸
動悸がする	洞性頻脈（どうせいじょうみゃく）	
動悸が激しい	動悸発作	動悸
動悸が速い	動悸発作	動悸
動悸に雑音がまじる	心雑音	心雑音
動機	息切れ	息切れ
動機が激しい	動悸発作	動悸
動脈のリンパ節が腫れて大きくなること	傍大動脈リンパ節腫大	リンパ節腫大
動脈の血の中のガス	動脈血ガス	血液ガス値異常
動脈の血液の中のガス	動脈血ガス	血液ガス値異常
動脈の酸性度	動脈血ガス	血液ガス値異常
動脈リンパ大きくなる	傍大動脈リンパ節腫大	リンパ節腫大
動脈リンパ節の腫れ	傍大動脈リンパ節腫大	リンパ節腫大
動脈内の血液のガス	動脈血ガス	血液ガス値異常
動脈性出血　静脈性出血	活動性出血	出血
動脈性出血と静脈性出血	活動性出血	出血
動脈血に含まれる酸素や二酸化炭素のこと	動脈血ガス	血液ガス値異常
動脈血液ガス	動脈血ガス	血液ガス値異常
勘変性	肝腫大	肝腫大
勝手に動く	不随意運動	不随意運動症
勝手に手足が動く	不随意運動	不随意運動症
勝手に震えが起こる	痙攣	痙攣
化膿	下肢浮腫	下肢浮腫
医療	ｍａｓｓ	腫瘤
医者行け	性器出血	性器出血
十分なできもの	充実性腫瘤	腫瘤
千鳥歩き	失調性歩行	失調性歩行
千鳥足	失調性歩行,ふらつき,歩行困難,歩行障害	失調性歩行,めまい,歩行困難,歩行障害
半ボケ	見当識障害	見当識障害
卒倒	見当識障害	見当識障害
単に血が混ざる	血痰	血痰
危篤	意識消失,意識レベル低下	意識消失,意識障害
即死	突然死	突然死
原に水がたまった	腹水	腹水症
原の左下痛い	左下腹部痛	下腹痛,臍下部痛
原因が分からない熱	不明熱	不明熱
原因が分からない発熱	不明熱	不明熱
原因の分からない熱	不明熱	不明熱
原因の分からない発熱	不明熱	不明熱
原因不明の急死	突然死	突然死
原因不明の死	突然死	突然死
原因不明の熱	不明熱	不明熱
原因不明の発熱	不明熱	不明熱
原因不明発熱	不明熱	不明熱
反射反応おかしい	姿勢反射障害	姿勢異常
口からとりいれづらい	経口摂取困難	経口摂取困難
口からものを食べてかみ砕いて飲み込むことが難しくなること	経口摂取不良	摂食機能障害
口から吐きたくなる状態	吐き気	嘔気
口から服用することが困難	経口摂取困難	経口摂取困難
口から栄養をとるのが難しい状態	経口摂取困難	経口摂取困難
口から物が食べられない	経口摂取不良	摂食機能障害
口から物を食べることが困難	経口摂取不良	摂食機能障害
口から物を食べることが難しい状態	経口摂取不良	摂食機能障害
口から血を吐く	喀血	喀血
口から食べることが難しい	経口摂取困難	経口摂取困難
口から食べ物が取れなくなること	経口摂取不良	摂食機能障害
口から飲み物や食べ物などを摂取することが困難な症状	経口摂取困難	経口摂取困難
口から飲み込んで薬や栄養物を体内に取り込むことが困難なこと	経口摂取困難	経口摂取困難
口から飲んだり食べたりできない	経口摂取不良	摂食機能障害
口から飲食ができない状態	経口摂取困難	経口摂取困難
口がうまくまわらない	呂律不良	不明瞭言語
口がかわく	口渇,口渇感	口渇症
口がまずい	味覚障害	味覚障害
口がまめらない	呂律困難	構音障害
口がまわらずうまくしゃべれない	呂律困難,呂律障害	構音障害
口がまわらない	呂律障害,呂律困難	構音障害
口がカラカラ	口渇	口渇症
口が乾いたかんじ	口渇感	口渇症
口が乾く	口渇,口渇感	口渇症
口が乾く感じ	口渇感	口渇症
口が乾く感覚	口渇感	口渇症
口が回らない	呂律困難,呂律不良,呂律障害,構音障害	構音障害,不明瞭言語
口が回らん	呂律困難	構音障害
口が渇いた	口渇	口渇症
口が渇く	口渇,口渇感	口渇症
口が渇くこと	口渇	口渇症
口が渇く感覚	口渇感	口渇症
口が聞けない	失語症	失語症
口で食べられない	経口摂取困難	経口摂取困難
口にできない	経口摂取不良	摂食機能障害
口による摂取困難	経口摂取困難	経口摂取困難
口の中がかわく	口渇感	口渇症
口の中が乾いている	口渇感	口渇症
口の中が乾く	口渇,口渇感	口渇症
口の中が乾く症状	口渇	口渇症
口の中が渇いたような感じがする	口渇感	口渇症
口の中が渇く	口渇	口渇症
口の中の渇き	口渇	口渇症
口の中の表面にブツブツができている	粘膜発赤	発赤
口の中パサパサ	口渇感	口渇症
口の乾き	口渇	口渇症
口の渇き	口渇,口渇感	口渇症
口を通して摂取出来ない	経口摂取困難	経口摂取困難
口中かわき	口渇感	口渇症
口中やのどが激しく乾いて感じること	口渇感	口渇症
口中渇き	口渇	口渇症
口内が乾く	口渇感	口渇症
口内炎	口渇感	口渇症
口渇	口渇	口渇症
口渇感	口渇感	口渇症
口熱	高熱	高熱
口腔内などに出来るはれ	粘膜浮腫	浮腫
右あばらの下の痛み	右季肋部痛	季肋部痛
右あばら痛	右季肋部痛	季肋部痛
右のおなかがいたい	右側腹部痛	側腹部痛
右のわき腹が痛いこと	右側胸部痛	胸痛
右の下っ腹が痛い	右下腹部痛	下腹痛,腸仙痛
右の下腹の痛み	右下腹部痛	下腹痛,腸仙痛
右の肋骨が痛い	右季肋部痛	季肋部痛
右の肋骨辺りの痛み	右上腹部痛	上腹部痛
右の肌が痛い	右上腹部痛	上腹部痛
右の胸が痛い	右側胸部痛,右胸痛,右胸部痛,右前胸部痛	胸痛,側胸部痛,前胸部痛
右の胸が痛くなる	右胸痛,右胸部痛	胸痛,側胸部痛
右の胸が痛む	右胸痛	胸痛
右の胸の痛み	右前胸部痛,右胸痛	前胸部痛,胸痛
右の胸部の痛み	右側胸部痛,右上腹部痛,右季肋部痛	胸痛,上腹部痛,季肋部痛
右の脇腹の痛み	右側腹部痛	側腹部痛
右の脇腹痛	右側腹部痛	側腹部痛
右の腹が痛い	右下腹部痛,右上腹部痛,右側腹部痛	下腹痛,腸仙痛,上腹部痛,側腹部痛
右の腹の痛み	右側腹部痛	側腹部痛
右の腹痛	右上腹部痛,右側腹部痛	上腹部痛,側腹部痛
右の腹部が痛い	右上腹部痛	上腹部痛
右むねいたい	右胸部痛	側胸部痛
右わき腹が痛い	右下腹部痛,右側腹部痛	下腹痛,腸仙痛,側腹部痛
右わき腹の痛み	右側胸部痛	胸痛
右わき腹疼痛	右側腹部痛	側腹部痛
右わき腹痛	右前胸部痛,右側腹部痛	前胸部痛,側腹部痛
右上あたりのお腹の痛み	右上腹部痛	上腹部痛
右上がだるい	右上肢脱力	脱力感
右上のおなかが痛い	右上腹部痛	上腹部痛
右上のお腹が痛い	右上腹部痛	上腹部痛
右上肢に力は入らなくなる	右上肢脱力	脱力感
右上肢のしびれ	右上肢脱力	脱力感
右上肢倦怠感	右上肢脱力	脱力感
右上肢麻痺	右上肢脱力	脱力感
右上腹が痛い	右上腹部痛	上腹部痛
右上腹部打撲	右上腹部痛	上腹部痛
右下のおなかがいたい	右下腹部痛	下腹痛,腸仙痛
右下の腹が痛い	右下腹部痛	下腹痛,腸仙痛
右下の腹痛	右下腹部痛	下腹痛,腸仙痛
右下側の腹痛	右下腹部痛	下腹痛,腸仙痛
右下腹の痛み	右下腹部痛	下腹痛,腸仙痛
右下腹痛	右下腹部痛	下腹痛,腸仙痛
右下腹部疼痛	右下腹部痛	下腹痛,腸仙痛
右下腹部痛	右下腹部痛	下腹痛,腸仙痛
右側のあしに力が入らない	右上肢脱力	脱力感
右側のお腹の上の方が痛い	右上腹部痛	上腹部痛
右側のむねがいたい	右側胸部痛	胸痛
右側の下腹部が痛み	右下腹部痛	下腹痛,腸仙痛
右側の肋骨の痛み	右季肋部痛	季肋部痛
右側の肋骨付近痛い	右季肋部痛	季肋部痛
右側の胸が痛い	右側胸部痛,右胸痛,右前胸部痛	胸痛,前胸部痛
右側の胸が痛いこと	右胸部痛	側胸部痛
右側の胸に痛みがある	右前胸部痛	前胸部痛
右側の胸のあたりが痛い症状	右前胸部痛	前胸部痛
右側の胸の前の部分が痛いこと	右前胸部痛	前胸部痛
右側の胸の痛み	右前胸部痛	前胸部痛
右側の腹が痛むこと	右上腹部痛	上腹部痛
右側の腹痛	右側腹部痛	側腹部痛
右側の腹痛の痛み	右側腹部痛	側腹部痛
右側の腹部が痛むこと	右側胸部痛	胸痛
右側上部の胸が痛い	右上腹部痛	上腹部痛
右側胸部打撲	右側胸部痛	胸痛
右側腹部痛	右側腹部痛	側腹部痛
右前胸部疼痛	右前胸部痛	前胸部痛
右太ももに力が入らない	右上肢脱力	脱力感
右季肋部疼痛	右季肋部痛	季肋部痛
右季肋部痛	右季肋部痛	季肋部痛
右横のお腹がいたい	右側腹部痛	側腹部痛
右横腹が痛い	右側腹部痛	側腹部痛
右横腹の痛み	右側腹部痛	側腹部痛
右肋骨の痛み	右季肋部痛	季肋部痛
右胸が痛い	右胸痛,右前胸部痛,右胸部痛,右側胸部痛,右季肋部痛	胸痛,前胸部痛,側胸部痛,季肋部痛
右胸が痛いこと	右側胸部痛	胸痛
右胸が痛む	右側胸部痛	胸痛
右胸の前の方が痛い	右前胸部痛	前胸部痛
右胸の痛み	右胸痛,右前胸部痛,右胸部痛,右側胸部痛	胸痛,前胸部痛,側胸部痛
右胸上部の痛み	右上腹部痛	上腹部痛
右胸打撲	右胸痛	胸痛
右胸痛い	右胸痛	胸痛
右胸部疼痛	右胸痛	胸痛
右胸部痛	右前胸部痛	前胸部痛
右脇腹が痛い	右側腹部痛,右側胸部痛,右下腹部痛,右上腹部痛	側腹部痛,胸痛,下腹痛,腸仙痛,上腹部痛
右脇腹の痛み	右側腹部痛,右季肋部痛	側腹部痛,季肋部痛
右脇腹下の方の痛み	右下腹部痛	下腹痛,腸仙痛
右脇腹痛	右側腹部痛	側腹部痛
右腕がだるい	右上肢脱力	脱力感
右腕に力がはいらない	右上肢脱力	脱力感
右腕に力が入らない	右上肢脱力	脱力感
右腕の力が入らない	右上肢脱力	脱力感
右腹が痛い	右下腹部痛,右側腹部痛	下腹痛,腸仙痛,側腹部痛
右腹の上の方が痛い	右上腹部痛	上腹部痛
右腹痛	右下腹部痛	下腹痛,腸仙痛
右足がだるい	右上肢脱力	脱力感
右足が腫れている	左下肢腫脹	下肢腫脹
右足の腿の部分が腫れている	左下腿浮腫	下腿浮腫
右足脱力	右上肢脱力	脱力感
吃り　	構音障害	構音障害
吃音	構音障害,構語障害,呂律障害,呂律困難	構音障害,構語障害
吃音障害	湿性ラ音	湿性ラ音
各種炎症	低補体血症	低補体血症
名前を忘れやすい	記銘力障害	記銘力低下,記憶障害
吐いた	嘔吐	嘔吐症
吐いた痰	喀痰	喀痰
吐きそう	嘔気,吐き気	嘔気
吐きそうだ	嘔気	嘔気
吐きっぽい	吐き気	嘔気
吐き戻し	嘔吐	嘔吐症
吐き戻し困難	嚥下困難感	嚥下困難
吐き気	嘔気,悪心,嘔気嘔吐,吐気,悪心嘔吐,嚥下痛,嘔吐,悪寒戦慄,腹部違和感,吐き気,上腹部不快感,胃部不快感	嘔気,悪心,嘔気,嘔吐症,悪心,嘔吐症,嚥下痛,嘔吐症,悪寒戦慄,腹部不快感
吐き気から吐く	嘔気嘔吐	嘔気,嘔吐症
吐き気がある	嘔気	嘔気
吐き気がする	嘔気嘔吐,嘔気,嘔吐,悪心嘔吐,吐気,悪心	嘔気,嘔吐症,嘔気,嘔吐症,悪心,嘔吐症,悪心
吐き気で吐く	悪心嘔吐	悪心,嘔吐症
吐き気と吐く	嘔気嘔吐,悪心嘔吐	嘔気,嘔吐症,悪心,嘔吐症
吐き気と嘔吐	悪心嘔吐	悪心,嘔吐症
吐き気または嘔吐	嘔気嘔吐	嘔気,嘔吐症
吐き気や吐くこと	悪心嘔吐	悪心,嘔吐症
吐き気や嘔吐	悪心嘔吐	悪心,嘔吐症
吐き気吐く	嘔気嘔吐	嘔気,嘔吐症
吐く	嘔吐,嘔気嘔吐	嘔吐症,嘔気,嘔吐症
吐くの難しい	嚥下困難	嚥下困難
吐く事	嘔吐	嘔吐症
吐出	悪心嘔吐	悪心,嘔吐症
吐息	吐気	嘔気
吐気	吐き気,嘔気,嘔気嘔吐	嘔気,嘔気,嘔吐症
吐瀉	嘔吐	嘔吐症
吐血	血痰,喀血,肺出血,喀痰,肺胞出血,出血性ショック	血痰,喀血,肺出血,喀痰,肺胞出血,出血性ショック
吹き出物	皮疹	発疹
呂律がまわらない	呂律不良,呂律障害	不明瞭言語,構音障害
呂律が回らない	呂律困難,呂律不良,呂律障害,構音障害,構語障害	構音障害,不明瞭言語,構語障害
呂律が回らない状態	呂律障害	構音障害
呂律障害	呂律不良	不明瞭言語
呆然自失	意識消失	意識消失
呑み込みが困難	嚥下障害	嚥下障害
呑み込みが悪い	嚥下困難感	嚥下困難
呑み込みにくい	嚥下困難,嚥下機能障害	嚥下困難,嚥下協調障害,嚥下障害
呑み込み機能障害	嚥下障害	嚥下障害
呑み込むことが難しくなること	嚥下障害	嚥下障害
呑み込めない	嚥下障害,嚥下困難感	嚥下障害,嚥下困難
周期に熱が出る	周期性発熱	発熱
周期性発熱	周期性発熱	発熱
周期的に熱がでる	周期性発熱	発熱
周期的に熱が出る	周期性発熱	発熱
周期的発熱	周期性発熱	発熱
味がおかしい	味覚異常,味覚障害	味覚異常,味覚障害
味がおかしい　	味覚障害	味覚障害
味がおかしくなる	味覚障害	味覚障害
味がしない	味覚異常,味覚障害	味覚異常,味覚障害
味がへん	味覚障害	味覚障害
味がよくわからないこと	味覚障害	味覚障害
味がよくわからなくなる	味覚障害	味覚障害
味がわからない	味覚障害,味覚異常,知覚障害	味覚障害,味覚異常,知覚障害
味がわからん	味覚異常,味覚障害	味覚異常,味覚障害
味が不自然に感じる	味覚異常	味覚異常
味が分からない	味覚障害	味覚障害
味が分からなくなる	味覚障害,味覚異常,感覚障害	味覚障害,味覚異常,体感異常
味が分からなくなる症状	味覚異常	味覚異常
味が変に感じる	味覚異常,味覚障害	味覚異常,味覚障害
味が正常に感じられない	味覚障害	味覚障害
味の感覚がおかしい	味覚障害	味覚障害
味をおかしく感じる事	味覚異常	味覚異常
味を正常に感じない	味覚異常	味覚異常
味オンチ	味覚障害	味覚障害
味不明	味覚障害	味覚障害
味覚	温痛覚低下	知覚鈍麻
味覚がおかしい	味覚異常	味覚異常
味覚が変	味覚異常	味覚異常
味覚バカ	味覚異常	味覚異常
味覚不良	味覚障害	味覚障害
味覚機能不全	味覚障害	味覚障害
味覚異常	味覚障害	味覚障害
味覚障害	味覚異常,知覚障害,温痛覚障害	味覚異常,知覚障害,温痛覚過敏
味覚音痴	味覚障害	味覚障害
味音痴	味覚障害,味覚異常	味覚障害,味覚異常
呼吸	起坐呼吸,吐気	起坐呼吸,嘔気
呼吸がうまくできない	息切れ	息切れ
呼吸がしにくい	呼吸苦,呼吸困難,呼吸困難感	呼吸促迫,呼吸困難,呼吸困難,呼吸麻痺
呼吸がしにくい感じ	呼吸困難感	呼吸麻痺
呼吸がし難い	呼吸困難感	呼吸麻痺
呼吸ができない	呼吸困難,呼吸苦	呼吸困難,呼吸促迫,呼吸困難
呼吸ができなくなる	呼吸困難感	呼吸麻痺
呼吸がとまる	呼吸停止	呼吸停止
呼吸がない	無呼吸	無呼吸発作
呼吸がないこと	無呼吸	無呼吸発作
呼吸がはやい	頻呼吸	頻呼吸
呼吸がままならない	息切れ	息切れ
呼吸がゼーゼー	喘鳴	喘鳴
呼吸が上手く出来ない感じ	呼吸困難感	呼吸麻痺
呼吸が不規則	呼吸苦	呼吸促迫,呼吸困難
呼吸が出来なくなる感じ	呼吸困難感	呼吸麻痺
呼吸が多い	頻呼吸	頻呼吸
呼吸が早い	頻呼吸	頻呼吸
呼吸が止まった状態	呼吸停止	呼吸停止
呼吸が止まっている	無呼吸	無呼吸発作
呼吸が止まっている状態	無呼吸	無呼吸発作
呼吸が止まって顔が紫になる	チアノーゼ	チアノーゼ
呼吸が止まる	呼吸停止,無呼吸	呼吸停止,無呼吸発作
呼吸が止まること	呼吸停止	呼吸停止
呼吸が止まる症状	無呼吸	無呼吸発作
呼吸が浅い	頻呼吸	頻呼吸
呼吸が激しい	頻呼吸	頻呼吸
呼吸が激しくなる	動悸	動悸
呼吸が苦しい	呼吸苦,息切れ,労作時呼吸苦	呼吸促迫,呼吸困難,息切れ,労作時呼吸困難
呼吸が苦しいような気がする	呼吸困難感	呼吸麻痺
呼吸が苦しくなる	労作時呼吸苦	労作時呼吸困難
呼吸が苦しくゼーゼーしている	喘鳴	喘鳴
呼吸が難しい	呼吸困難感	呼吸麻痺
呼吸が難しいこと	呼吸困難	呼吸困難
呼吸が難しいと感じること	呼吸困難感	呼吸麻痺
呼吸しずらい	労作性呼吸困難	発作性呼吸困難,労作時呼吸困難
呼吸しづらい	呼吸苦	呼吸促迫,呼吸困難
呼吸していない	無呼吸	無呼吸発作
呼吸してない	無呼吸	無呼吸発作
呼吸しにくい	呼吸困難,呼吸困難感	呼吸困難,呼吸麻痺
呼吸し辛くなる	呼吸困難	呼吸困難
呼吸するための筋肉が動かなくなる	呼吸筋麻痺	呼吸麻痺
呼吸する空気が気管を通る時ぜいぜいと雑音を発すること	喘鳴	喘鳴
呼吸する筋肉の麻痺	呼吸筋麻痺	呼吸麻痺
呼吸なし	呼吸停止,無呼吸	呼吸停止,無呼吸発作
呼吸の異常	ｆｉｎｅ　ｃｒａｃｋｌｅｓ	湿性ラ音
呼吸の頻度が高い	頻呼吸	頻呼吸
呼吸ほっさ	呼吸筋麻痺	呼吸麻痺
呼吸をしていない	無呼吸	無呼吸発作
呼吸をしていない。	無呼吸	無呼吸発作
呼吸をしていない状態	無呼吸	無呼吸発作
呼吸をしない	無呼吸	無呼吸発作
呼吸をしにくい	呼吸困難感	呼吸麻痺
呼吸不全	高二酸化炭素血症,呼吸筋麻痺,無呼吸,閉塞性換気障害,呼吸困難,高炭酸ガス血症,低酸素血症,肺胞出血,呼吸停止,労作時呼吸困難	高炭酸ガス血症,呼吸麻痺,無呼吸発作,閉塞性換気障害,呼吸困難,低酸素血症,肺胞出血,呼吸停止,労作時呼吸困難
呼吸不能	呼吸困難	呼吸困難
呼吸以上	頻呼吸	頻呼吸
呼吸停止	無呼吸	無呼吸発作
呼吸劣化	嚥下困難感	嚥下困難
呼吸器が閉じて障害が起こる	閉塞性換気障害	閉塞性換気障害
呼吸器疾患	閉塞性換気障害,労作時呼吸困難	閉塞性換気障害,労作時呼吸困難
呼吸回数が多くなる	頻呼吸	頻呼吸
呼吸困難	呼吸苦,息切れ,労作性呼吸困難,呼吸筋麻痺,低酸素血症,胸膜炎,労作時呼吸苦,チアノーゼ,頻呼吸,労作時息切れ,高二酸化炭素血症,起坐呼吸,胸痛発作,呼吸困難感,胸部圧迫感	呼吸促迫,呼吸困難,息切れ,発作性呼吸困難,労作時呼吸困難,呼吸麻痺,低酸素血症,胸膜炎,労作時呼吸困難,チアノーゼ,頻呼吸,高炭酸ガス血症,起坐呼吸,胸痛,胸内苦悶
呼吸困難が臥位で増強	起坐呼吸	起坐呼吸
呼吸困難感	労作時呼吸苦	労作時呼吸困難
呼吸数が多い	頻呼吸	頻呼吸
呼吸時音が鳴る	喘鳴	喘鳴
呼吸異常	呼吸筋麻痺,息切れ	呼吸麻痺,息切れ
呼吸苦	呼吸筋麻痺,労作時呼吸困難,呼吸困難感	呼吸麻痺,労作時呼吸困難
呼吸障害	呼吸困難,呼吸苦,頻呼吸,呼吸困難感	呼吸困難,呼吸促迫,呼吸困難,頻呼吸,呼吸麻痺
呼吸障害感	呼吸困難感	呼吸麻痺
呼吸雑音	喘鳴	喘鳴
呼吸音	ｆｉｎｅ　ｃｒａｃｋｌｅｓ	湿性ラ音
呼吸音がおかしい	喘鳴	喘鳴
呼吸麻痺	呼吸筋麻痺	呼吸麻痺
呼気	吐気	嘔気
咳	咳嗽,湿性咳嗽,乾性咳嗽,慢性咳嗽,乾性咳,労作時息切れ,咳,血痰,発赤,息切れ	咳,湿性咳,慢性咳嗽,乾性咳,慢性咳嗽,息切れ,血痰,発赤
咳から出た痰	喀痰	喀痰
咳がかんたんに治らない	慢性咳嗽	慢性咳嗽
咳がとまらない	咳嗽	咳
咳が出る	咳嗽,吐気,湿性咳嗽	咳,嘔気,湿性咳,慢性咳嗽
咳が常に出る	慢性咳嗽	慢性咳嗽
咳が抜けない子と	慢性咳嗽	慢性咳嗽
咳が止まらない	慢性咳嗽	慢性咳嗽
咳が止まらん	慢性咳嗽	慢性咳嗽
咳が長引く	慢性咳嗽	慢性咳嗽
咳き込む	咳嗽	咳
咳と共に血を吐くこと	喀血	喀血
咳と痰がでる	喀痰	喀痰
咳出て痰もでる	喀痰	喀痰
咳出る	咳嗽	咳
咳喘息	咳	咳
咳嗽	膿性痰,咳,湿性咳嗽,喀痰	膿性痰,咳,湿性咳,慢性咳嗽,喀痰
咳払い	嘔気嘔吐	嘔気,嘔吐症
咳込む	咳嗽	咳
咳込んでえらい	咳嗽	咳
咳込んで息苦しい	咳嗽	咳
咽頭痛	嚥下痛	嚥下痛
品物の名前を書く能力が低下すること	記銘力低下	記銘力低下
唇が紫色になる	チアノーゼ	チアノーゼ
唇などが紫色になること	チアノーゼ	チアノーゼ
唾	痰	喀痰
唾液	痰	喀痰
唾液が出ない	口渇	口渇症
唾液腺腫脹	耳下腺腫脹	耳下腺腫脹
喀痰	痰,膿性痰	喀痰,膿性痰
喀血	血痰,喀血,肺出血	血痰,喀血,肺出血
喉あれ	咳	咳
喉から出る粘着質	痰	喀痰
喉がいがらっぽい	乾性咳,乾性咳嗽	乾性咳
喉がかわく	口渇感	口渇症
喉がむせる	咳	咳
喉がゼイゼイする	喘鳴	喘鳴
喉が乾いた感じ	口渇感	口渇症
喉が乾く	口渇	口渇症
喉が乾燥する	乾性咳嗽	乾性咳
喉が渇いた	口渇	口渇症
喉が渇きやすくトイレも近い	多飲多尿	多飲症,多尿
喉が渇く	口渇,口渇感,多飲	口渇症,多飲症
喉が腫れる	粘膜発赤	発赤
喉が苦しい	嚥下困難感	嚥下困難
喉が詰まる	嚥下困難感	嚥下困難
喉に詰まる	嚥下障害	嚥下障害
喉に違和感	嚥下障害	嚥下障害
喉のおでき	頚部腫瘤	頚部腫瘤
喉のかわき	口渇感	口渇症
喉の渇き	口渇感,多飲,口渇	口渇症,多飲症
喉の異物が引っ掛かかって咳が出る	咳嗽	咳
喉の疾病ででる症状	咳	咳
喉の絡み	痰	喀痰
喉の閉塞感	嚥下困難感	嚥下困難
喉乾き	口渇感	口渇症
喉痛	嚥下痛,嚥下機能障害	嚥下痛,嚥下協調障害,嚥下障害
喉痛い	疼痛	疼痛
喉頭炎	嚥下痛	嚥下痛
喋りにくさ	構音障害	構音障害
喋り方がおかしい	構語障害	構語障害
喋れない	失語,運動性失語,呂律困難,呂律障害	失語症,運動性失語症,構音障害
喘ぎ	喘鳴	喘鳴
喘ぐ	息切れ	息切れ
喘息	喘鳴,慢性咳嗽,呼吸筋麻痺,起坐呼吸,労作時息切れ,肺腫瘤,乾性咳嗽,呼吸困難	喘鳴,慢性咳嗽,呼吸麻痺,起坐呼吸,息切れ,肺腫瘤,乾性咳,呼吸困難
喘息の人の呼吸	喘鳴	喘鳴
喘鳴	喘鳴	喘鳴
嗄声	嗄声	嗄声
嗚咽	喘鳴,嘔気嘔吐,吐き気	喘鳴,嘔気,嘔吐症,嘔気
嘔吐	悪心嘔吐,吐き気,吐気,悪心,膵性胸水,嘔気	悪心,嘔吐症,嘔気,悪心,胸水検査異常
嘔吐したくなる	吐き気	嘔気
嘔吐感	吐き気,吐気,嘔気,嘔気嘔吐	嘔気,嘔気,嘔吐症
嘔気	吐き気,吐気	嘔気
噛んで血	喀血	喀血
噛んで飲み込むことができないまたはできずらい	嚥下困難	嚥下困難
嚢胞に出血がある	嚢胞内出血	内出血
嚢胞の中で血が出てる	嚢胞内出血	内出血
嚢胞の中に血がでる	嚢胞内出血	内出血
嚢胞出血	嚢胞内出血	内出血
嚥下の難しい状態	嚥下困難感	嚥下困難
嚥下困難	嚥下障害,経口摂取不良,嚥下困難,嚥下困難感	嚥下障害,摂食機能障害,嚥下困難
嚥下時に誘発される疼痛	嚥下痛	嚥下痛
嚥下障害	嚥下困難,嚥下機能障害,嚥下困難感,経口摂取不良	嚥下困難,嚥下協調障害,嚥下障害,摂食機能障害
四十肩	右上肢脱力	脱力感
四肢のむくみ	四肢浮腫	四肢浮腫
四肢の筋肉の力が落ちる	四肢筋力低下	四肢筋力低下
四肢脱力	右上肢脱力	脱力感
固くなる	こわばり,固縮	こわばり
固く突っ張ったようになる	こわばり	こわばり
固く縮む	固縮	こわばり
固まったままブルブル震える	強直性痙攣	強直性痙攣
固まっているさま	こわばり	こわばり
固まって動きにくい	こわばり	こわばり
固まって圧縮されたもの	固縮	こわばり
固まって縮む	固縮	こわばり
固まる	固縮,こわばり	こわばり
固まること	硬結	硬結
固まると血豆	血性腹水	血性腹水
圧痕性浮腫	ｐｉｔｔｉｎｇ　ｅｄｅｍａ	浮腫
圧痕浮腫	ｐｉｔｔｉｎｇ　ｅｄｅｍａ	浮腫
圧痛	軽度圧痛	圧痛
圧迫	圧痛,心窩部痛,胸痛,胸部圧迫感,腹部膨満感	圧痛,心窩部痛,胸痛,胸内苦悶,腹部膨満
圧迫されいたいこと	軽度圧痛	圧痛
圧迫されたような痛み	圧痛	圧痛
圧迫された痛み	圧痛	圧痛
圧迫される	圧痛	圧痛
圧迫されることで腫れる	圧痕浮腫	浮腫
圧迫されるような痛み	圧痛	圧痛
圧迫したときに感じる痛み	圧痛	圧痛
圧迫したときに感ずるかるい痛み	軽度圧痛	圧痛
圧迫した時の痛み	圧痛	圧痛
圧迫して赤くなった	圧痕性浮腫	浮腫
圧迫によるむくみ	圧痕浮腫	浮腫
圧迫による浮腫	圧痕性浮腫	浮腫
圧迫感	軽度圧痛	圧痛
圧迫感がある	胸部圧迫感	胸内苦悶
圧迫感のある痛み	圧痛	圧痛
圧迫痛	圧痛,軽度圧痛	圧痛
坐骨神経痛	下肢疼痛	疼痛
塊	ｍａｓｓ	腫瘤
増体重	体重増加	体重増加
壊死	乾酪壊死	壊死
声	嗄声	嗄声
声がうまく出ない	嗄声	嗄声
声がおかしい	嗄声	嗄声
声がかすれる	嗄声	嗄声
声がかれる	嗄声	嗄声
声がでない	失語	失語症
声が出ない	運動性失語,失語症,失語,構音障害	運動性失語症,失語症,構音障害
声が出なくなる	失語	失語症
声が出にくい	嗄声	嗄声
声が嗄れる	嗄声	嗄声
声が枯れる	嗄声	嗄声
声枯	嗄声	嗄声
声枯れ	嗄声	嗄声
変なものが見える	幻覚	幻覚
変な動き	異常行動	異常行動
変な感じ	異常感覚	異常触覚,異常知覚
変な感じがする	異常感覚	異常触覚,異常知覚
変な行動	異常行動	異常行動
変化	腫瘤病変	腫瘤
変死	突然死	突然死
変色	黄疸	黄疸
外傷はないが身体が怠い状態	全身倦怠感	全身倦怠感
多い	ｍａｓｓ	腫瘤
多くの水分を飲みたがる状態	多飲	多飲症
多くの臓器がうまく働かない	多臓器障害	多臓器不全
多くの臓器がうまく動かない	多臓器障害	多臓器不全
多くの臓器が動かなくなる	多臓器不全	多臓器不全
多くの臓器が正常に機能できていない状態	多臓器障害	多臓器不全
多く腫瘍や瘤が出ること	多発性腫瘤	腫瘤
多く飲む	多飲	多飲症
多く飲んで多く排出する	多飲多尿	多飲症,多尿
多動悸	頻脈	頻脈症,洞頻脈
多器官障害	多臓器不全	多臓器不全
多尿	頻尿,多飲,多尿	多尿,頻尿症,多飲症,多尿
多数のリンパが腫れる	多発リンパ節腫大	リンパ節腫大
多数のリンパ線が腫れる	多発リンパ節腫大	リンパ節腫大
多汗	発汗過多	多汗症
多汗症	発汗過多	多汗症
多淡白尿	蛋白尿	蛋白尿
多疲労	易疲労感	易疲労感
多臓器不全	多臓器障害,多臓器不全	多臓器不全
多臓器不良	多臓器障害	多臓器不全
多臓器疾患	多臓器障害	多臓器不全
多量出血	出血性ショック	出血性ショック
多飲	多飲	多飲症
夜おしっこしたくなる	夜間頻尿	夜間頻尿症
夜おしっこ近い	夜間頻尿	夜間頻尿症
夜におしっこ	夜間頻尿	夜間頻尿症
夜に何度もおしっこにいくこと	夜間頻尿	夜間頻尿症
夜に何度も小便がしたくなる	夜間頻尿	夜間頻尿症
夜に何度も尿意がある	夜間頻尿	夜間頻尿症
夜トイレに行きたくなる	夜間頻尿	夜間頻尿症
夜中にトイレに起きる	夜間頻尿	夜間頻尿症
夜中に何度もトイレに行きたくなること	夜間頻尿	夜間頻尿症
夜中に頻繁にトイレに行きたくなる	夜間頻尿	夜間頻尿症
夜中寝ているときに何度もおしっこしたくなる	夜間頻尿	夜間頻尿症
夜寝ていてもおしっこが近い	夜間頻尿	夜間頻尿症
夜尿症	夜間頻尿	夜間頻尿症
夜間におしっこが近くなる	夜間頻尿	夜間頻尿症
夜間に尿が多い	夜間頻尿	夜間頻尿症
夜間何度も排尿する	夜間頻尿	夜間頻尿症
大きいブツブツ	丘疹	丘疹
大きさ	ｍａｓｓ	腫瘤
大きなおでき腫れ	巨大腫瘤	腫瘤
大きなこぶ	巨大腫瘤	腫瘤
大きなたんこぶ	巨大腫瘤	腫瘤
大きな出来物	巨大腫瘤	腫瘤
大きな癌	巨大腫瘤	腫瘤
大きな腫れ	腫大	リンパ節腫大
大きな腫れ物	巨大腫瘤,腫大	腫瘤,リンパ節腫大
大便が黒い	黒色便	黒色便
大出血	大量出血,出血性ショック	多量出血,出血性ショック
大動脈の近くのリンパ節が腫れて大きくなる症状	傍大動脈リンパ節腫大	リンパ節腫大
大動脈リンパ腫瘍大	傍大動脈リンパ節腫大	リンパ節腫大
大汗	発汗過多	多汗症
大腸異常	吐き気	嘔気
大量な出血量	大量出血	多量出血
大量な血	出血性ショック	出血性ショック
大量に血が出る	大量出血	多量出血
大量の出血でショック状態になる	出血性ショック	出血性ショック
大量の水がお腹にたまる	大量腹水	腹水症
大量の汗	発汗過多	多汗症
大量出血	出血性ショック,活動性出血	出血性ショック,出血
大量出血して危険な状態	出血性ショック	出血性ショック
太った	体重増加	体重増加
太ももがむくんでる	両下腿浮腫	下腿浮腫
太りすぎ	腹部膨隆	腹部膨満
太る	体重増加	体重増加
太腿のむくみ	下腿浮腫	下腿浮腫
失神	意識消失発作,一過性意識障害,意識消失,失神発作,意識障害,意識レベル低下,見当識障害,けいれん,意識レベルの低下	眼前暗黒,虚脱,血管迷走神経性失神,失神,心臓性失神,卒倒,単純性失神,排尿性失神,労作性失神,一過性意識障害,意識消失,失神,意識障害,見当識障害,痙攣
失神する	失神発作	失神
失神するほどてんかんの発作が現れる	失神発作	失神
失神の発作	失神発作	失神
失見当識	見当識障害	見当識障害
失言	失語症,失語	失語症
失語	失語	失語症
失語症	運動性失語,失語	運動性失語症,失語症
奇妙なふるまい	異常行動	異常行動
奇妙な行動	異常行動	異常行動
姿勢の反射障害	姿勢反射障害	姿勢異常
姿勢振戦	手指振戦	手指振戦
嫌な予感	悪寒	悪寒
子宮筋腫	腹腔内リンパ節腫脹,腹腔内リンパ節腫大	リンパ節腫大
字が書けない	記銘力障害	記銘力低下,記憶障害
安静にしてあるのに胸に痛みがある	安静時胸痛	反復性胸痛,胸痛
安静にしているが胸の痛みがある	安静時胸痛	反復性胸痛,胸痛
安静にしていると呼吸できない症状	安静時呼吸困難	呼吸困難
安静にしてきても呼吸ができない	安静時呼吸困難	呼吸困難
安静にしてても胸が痛い	安静時胸痛	反復性胸痛,胸痛
安静にしても呼吸が苦しい	安静時呼吸困難	呼吸困難
安静時のふるえ	安静時振戦	静止時振戦
安静時息切れ	安静時呼吸困難	呼吸困難
安静時震え	安静時振戦	静止時振戦
定期的な熱	周期性発熱	発熱
定期的な発熱	周期性発熱	発熱
定期的に熱が出る	周期性発熱	発熱
定期的に熱を出す	周期性発熱	発熱
宿便	タール便	黒色便
寒いとか触ってるとかの感覚が鈍っている	感覚鈍麻	感覚異常症
寒くないのに体が震える	悪寒	悪寒
寒け	悪寒戦慄	悪寒戦慄
寒気	悪寒,悪寒戦慄,悪心,温痛覚低下	悪寒,悪寒戦慄,悪心,知覚鈍麻
寒気がして身震いする	悪寒戦慄	悪寒戦慄
寒気がする	悪寒戦慄,悪寒	悪寒戦慄,悪寒
寒気で震える	悪寒戦慄	悪寒戦慄
寒気と共にブルブルと震える	悪寒戦慄	悪寒戦慄
寒気と吐き気	悪心嘔吐	悪心,嘔吐症
寒気感じる	悪寒戦慄	悪寒戦慄
寝ていても息苦しい	安静時呼吸困難	呼吸困難
寝ている時の胸の痛み	安静時胸痛	反復性胸痛,胸痛
寝てるときからだがふるえる	安静時振戦	静止時振戦
寝てるときに呼吸が止まる	無呼吸	無呼吸発作
寝汗	盗汗	寝汗
寝汗をかく	盗汗	寝汗
寡尿	乏尿	乏尿
小さな落石	落屑	鱗屑
小便が出ない	排尿困難,無尿	排尿困難,無尿
小便にたんぱく混ざる	蛋白尿	蛋白尿
小便に血が混じっている	尿潜血	顕微鏡的血尿
小便をするときにいたい	排尿時痛	排尿痛
少しの熱	微熱	微熱
少し動くと胸が痛い	労作時胸痛	反復性胸痛,胸痛
少し反応するしこり	低エコー腫瘤	腫瘤
少し怠い	微熱	微熱
少し意思疎通ができない状態	軽度意識障害	意識障害
少し意識がもうろうとする	軽度意識障害	意識障害
少し押されるような痛みがある	軽度圧痛	圧痛
少し朦朧とする	軽度意識障害	意識障害
少し気が動転して物事がよくわからない状態	軽度意識障害	意識障害
少し熱がある	微熱	微熱
少し熱が高い	微熱	微熱
少し疲労	易疲労感	易疲労感
少し痛い	軽度圧痛	圧痛
少し腫れている症状	軽度腫大	リンパ節腫大
少食	食欲不振	食欲不振
尻筋低下	排尿困難	排尿困難
尿からたんぱく質が出る	蛋白尿	蛋白尿
尿がうまくできない	排尿障害	排尿障害
尿がたくさん出る	多尿	多尿
尿ができない	無尿	無尿
尿がでない	無尿	無尿
尿がでないこと	尿閉	尿閉
尿がでないさま	乏尿	乏尿
尿がでにくい	頻尿	多尿,頻尿症
尿がでる時の痛み	排尿時痛	排尿痛
尿がない	無尿状態	無尿
尿が出ない	無尿,尿閉,無尿状態,乏尿,排尿困難	無尿,尿閉,乏尿,排尿困難
尿が出ないこと	尿閉	尿閉
尿が出ない状態	無尿状態	無尿
尿が出なくなる	乏尿	乏尿
尿が出なくなる状態	無尿	無尿
尿が出にくい	排尿障害,排尿困難,尿閉,乏尿	排尿障害,排尿困難,尿閉,乏尿
尿が出にくいこと	乏尿	乏尿
尿が出る回数が多い	頻尿	多尿,頻尿症
尿が出る量は少ない	乏尿	乏尿
尿が増える	多尿	多尿
尿が変だ	顕微鏡的血尿	顕微鏡的血尿
尿が多い	多飲多尿,多尿	多飲症,多尿,多尿
尿が少ない	乏尿	乏尿
尿が思うように排出できない	排尿障害	排尿障害
尿が正常に排出されない	排尿障害	排尿障害
尿が正常に排出しない	排尿困難	排尿困難
尿が濃い	褐色尿	ビリルビン尿
尿が白い	高度蛋白尿	蛋白尿
尿が褐色であること	褐色尿	ビリルビン尿
尿が赤い	褐色尿	ビリルビン尿
尿が近い	頻尿	多尿,頻尿症
尿が遠い	乏尿	乏尿
尿が頻繁	頻尿,多尿	多尿,頻尿症,多尿
尿が頻繁に出る	頻尿	多尿,頻尿症
尿が黄色い	褐色尿	ビリルビン尿
尿たんぱく	蛋白尿	蛋白尿
尿といっしょに蛋白がおりている	蛋白尿	蛋白尿
尿なし	無尿	無尿
尿などに微量の血液成分が混ざること	潜血	顕微鏡的血尿
尿にたんぱくが下りている	蛋白尿	蛋白尿
尿にたんぱくが多く含まれていること	蛋白尿	蛋白尿
尿にたんぱくが混ざる	蛋白尿	蛋白尿
尿にたんぱくが混じっている	尿蛋白	蛋白尿
尿にたんぱくが混じる	蛋白尿	蛋白尿
尿にたんぱく質がでる	蛋白尿,高度蛋白尿	蛋白尿
尿にタンパクがでる	高度蛋白尿	蛋白尿
尿にタンパクが出る	高度蛋白尿,蛋白尿	蛋白尿
尿にタンパクが混ざってる	蛋白尿	蛋白尿
尿にタンパクが混じる	蛋白尿	蛋白尿
尿にタンパク出とる	蛋白尿	蛋白尿
尿にタンパク質が含まれる症状	尿蛋白	蛋白尿
尿に含まれるたんぱく	尿蛋白	蛋白尿
尿に含まれるたんぱく質	尿蛋白	蛋白尿
尿に含まれるたんぱく質が多すぎる	高度蛋白尿	蛋白尿
尿に多くの蛋白が出ていること	高度蛋白尿	蛋白尿
尿に淡白成分が過剰に降りている	尿蛋白	蛋白尿
尿に蛋白がでている	蛋白尿	蛋白尿
尿に蛋白がみられること	蛋白尿	蛋白尿
尿に蛋白が出る	蛋白尿,尿蛋白	蛋白尿
尿に蛋白が多い	高度蛋白尿	蛋白尿
尿に蛋白が混じる	尿蛋白	蛋白尿
尿に血	潜血	顕微鏡的血尿
尿に血がまざる	肉眼的血尿	肉眼的血尿
尿に血がまじる	尿潜血,肉眼的血尿,血尿	顕微鏡的血尿,肉眼的血尿,血尿
尿に血が混ざる	血尿,尿潜血	血尿,顕微鏡的血尿
尿に血が混じっている	血尿	血尿
尿に血が混じっとる	尿潜血	顕微鏡的血尿
尿に血が混じる	血尿,尿潜血,顕微鏡的血尿	血尿,顕微鏡的血尿
尿に血が混じること	血尿	血尿
尿に血液が流れ込む	血尿	血尿
尿に血液が混じってる	血尿	血尿
尿のなかに蛋白が含まれていること	蛋白尿	蛋白尿
尿のタンパク反応	尿蛋白	蛋白尿
尿の中に排出されたたんぱく質	尿蛋白	蛋白尿
尿の回数が多い	頻尿	多尿,頻尿症
尿の排泄量が低下	乏尿	乏尿
尿の色がこい	褐色尿	ビリルビン尿
尿の色が濃い	褐色尿	ビリルビン尿
尿の色が褐色	褐色尿	ビリルビン尿
尿の色が黒い	褐色尿	ビリルビン尿
尿の蛋白	尿蛋白	蛋白尿
尿の量が尋常でない	多尿	多尿
尿へい	無尿	無尿
尿もれ	排尿障害	排尿障害
尿をすることが難しい	排尿困難	排尿困難
尿タンパク	蛋白尿	蛋白尿
尿不全	無尿状態	無尿
尿中に含まれるタンパク質	蛋白尿	蛋白尿
尿停止	無尿状態	無尿
尿意が頻繁におきる	頻尿	多尿,頻尿症
尿意を忘れる	乏尿	乏尿
尿時の痛み	排尿時痛	排尿痛
尿検査の結果血がまじっている	顕微鏡的血尿	顕微鏡的血尿
尿毒症	尿閉,無尿状態	尿閉,無尿
尿潜血	血尿,顕微鏡的血尿	血尿,顕微鏡的血尿
尿痛	排尿時痛	排尿痛
尿管結石	排尿困難	排尿困難
尿結石	肉眼的血尿	肉眼的血尿
尿蛋白	蛋白尿,高度蛋白尿	蛋白尿
尿血栓	無尿	無尿
尿過多	多尿	多尿
尿道炎	尿潜血,排尿時痛	顕微鏡的血尿,排尿痛
尿道痛い	排尿時痛	排尿痛
尿量が増加	多尿	多尿
尿量が増加した状態	多尿	多尿
尿量が多い	多尿	多尿
尿量が少ない	無尿	無尿
尿量が少ないこと	乏尿	乏尿
尿量が減少する	乏尿	乏尿
尿量の減少	乏尿	乏尿
尿量増加	多尿	多尿
尿量減少	無尿	無尿
尿量過多	多尿	多尿
尿閉	無尿状態	無尿
尿障害	無尿状態	無尿
局部出血	性器出血	性器出血
川崎病	頚部リンパ節腫脹	頚部リンパ節腫脹
左くびのリンパの腫れ	左頚部リンパ節腫脹	頚部リンパ節腫脹
左のおなかがいたい	左下腹部痛,左側腹部痛	下腹痛,臍下部痛,側腹部痛
左のお腹上部の痛み	左上腹部痛	上腹部痛
左のわきの下が痛い	左上腹部痛	上腹部痛
左の下腹の痛み	左下腹部痛	下腹痛,臍下部痛
左の下腹部痛	左下腹部痛	下腹痛,臍下部痛
左の肋骨が痛い	左季肋部痛	季肋部痛
左の肋骨下が痛い	左季肋部痛	季肋部痛
左の胸が痛い	左前胸部痛,左側胸部痛,左胸部痛,左胸痛	前胸部痛,側胸部痛,胸痛
左の胸が痛くなる	左胸痛	胸痛
左の胸が痛む	左胸痛	胸痛
左の胸の痛み	左側胸部痛,左胸痛,左胸部痛,左前胸部痛	側胸部痛,胸痛,前胸部痛
左の胸部が痛い	左側胸部痛	側胸部痛
左の胸部が痛む	左季肋部痛	季肋部痛
左の胸部の痛み	左季肋部痛	季肋部痛
左の脇腹痛	左側腹部痛	側腹部痛
左の脚のむくみ	左下肢腫脹	下肢腫脹
左の腫れ	左下肢腫脹	下肢腫脹
左の腹が痛い	左下腹部痛,左上腹部痛,左側腹部痛	下腹痛,臍下部痛,上腹部痛,側腹部痛
左の腹痛	左上腹部痛,左側腹部痛,左下腹部痛,側腹部痛	上腹部痛,側腹部痛,下腹痛,臍下部痛
左の腹部の痛み	左前胸部痛,左側胸部痛	前胸部痛,側胸部痛
左の腿がはれる	左下腿腫脹	下腿腫脹
左の足のはれ	左下肢腫脹	下肢腫脹
左の足の下部の皮下組織に組織間液がたまること	左下腿浮腫	下腿浮腫
左の首のリンパが腫れる	左頚部リンパ節腫脹	頚部リンパ節腫脹
左ももがむくんでいる	左下腿浮腫	下腿浮腫
左わきの部分が痛い	左側胸部痛	側胸部痛
左わき腹が痛い	左下腹部痛	下腹痛,臍下部痛
左わき腹の痛み	左側腹部痛	側腹部痛
左わき腹疼痛	左側腹部痛	側腹部痛
左わき腹痛	左上腹部痛	上腹部痛
左上のお腹が痛い	左上腹部痛	上腹部痛
左上の腹部の痛み	左上腹部痛	上腹部痛
左上腹痛	左上腹部痛	上腹部痛
左上腹部の痛み	左季肋部痛	季肋部痛
左上腹部打撲	左上腹部痛	上腹部痛
左下の腫物	左下腿腫脹	下腿腫脹
左下の腹痛	左下腹部痛	下腹痛,臍下部痛
左下脚むくみ	左下腿浮腫	下腿浮腫
左下腹の痛み	左下腹部痛	下腹痛,臍下部痛
左下腹部疼痛	左下腹部痛	下腹痛,臍下部痛
左下腹部痛	左下腹部痛	下腹痛,臍下部痛
左下腿腫れ	左下腿腫脹	下腿腫脹
左側うえの腹の痛み	左上腹部痛	上腹部痛
左側がお腹痛い	左側腹部痛	側腹部痛
左側が非常にいたい	左季肋部痛	季肋部痛
左側のおなかが痛い	左側腹部痛	側腹部痛
左側のおなかの痛み	左下腹部痛	下腹痛,臍下部痛
左側のお腹が痛い	左側腹部痛	側腹部痛
左側の季肋が痛い	左季肋部痛	季肋部痛
左側の肋骨が痛い	左季肋部痛	季肋部痛
左側の肋骨部が痛い症状	左季肋部痛	季肋部痛
左側の胸が痛い	左胸痛	胸痛
左側の胸部が痛い	左側胸部痛	側胸部痛
左側の腹が痛い	左側腹部痛	側腹部痛
左側の腹部痛	左側腹部痛	側腹部痛
左側の足の腫れ	左下腿腫脹	下腿腫脹
左側の首のはれ	左頚部リンパ節腫脹	頚部リンパ節腫脹
左側胸部打撲	左側胸部痛	側胸部痛
左側腹部痛	左側腹部痛	側腹部痛
左前の胸部に痛みがある	左前胸部痛	前胸部痛
左前胸部の痛み	左前胸部痛	前胸部痛
左前胸部打撲	左前胸部痛	前胸部痛
左右の足のむくみ	両下肢浮腫	下肢浮腫
左右下腿むくみ	両下腿浮腫	下腿浮腫
左喉のガン	左頚部リンパ節腫脹	頚部リンパ節腫脹
左季肋部打撲	左季肋部痛	季肋部痛
左横っ腹が痛い	左側腹部痛	側腹部痛
左横腹が痛い	左側腹部痛	側腹部痛
左胸がいたい	左胸部痛	胸痛
左胸が痛い	左胸痛,左側胸部痛,左胸部痛,左季肋部痛,左前胸部痛	胸痛,側胸部痛,季肋部痛,前胸部痛
左胸が痛いこと	左胸部痛	胸痛
左胸に痛みがはしる	左側胸部痛	側胸部痛
左胸のいたみ	左側胸部痛	側胸部痛
左胸の前の方痛い	左前胸部痛	前胸部痛
左胸の痛み	左前胸部痛,左胸痛,左側胸部痛,左胸部痛	前胸部痛,胸痛,側胸部痛
左胸の脇が痛い	左側胸部痛	側胸部痛
左胸打撲	左胸痛	胸痛
左胸痛	左側胸部痛,左前胸部痛	側胸部痛,前胸部痛
左胸部の痛み	左胸部痛	胸痛
左胸部疼痛	左胸痛	胸痛
左脇腹の痛み	左側腹部痛,左下腹部痛	側腹部痛,下腹痛,臍下部痛
左脇腹痛	左側腹部痛	側腹部痛
左脚のむくみ	左下腿浮腫	下腿浮腫
左脚の下の方がむくんでいる	左下腿浮腫	下腿浮腫
左脚の腫れ	左下腿腫脹	下腿腫脹
左腹が痛い	左下腹部痛,左側腹部痛	下腹痛,臍下部痛,側腹部痛
左腹痛	左下腹部痛	下腹痛,臍下部痛
左膝下のむくみ	左下腿浮腫	下腿浮腫
左足がむくむ	左下腿浮腫	下腿浮腫
左足がむくむ症状	左下腿浮腫	下腿浮腫
左足が腫れる	左下肢腫脹	下肢腫脹
左足のできもの	左下腿浮腫	下腿浮腫
左足のむくみ	左下肢腫脹,左下腿浮腫	下肢腫脹,下腿浮腫
左足の腫れ	左下腿腫脹,左下肢腫脹	下腿腫脹,下肢腫脹
左足腫れ	左下肢腫脹	下肢腫脹
左頚部リンパ節腫れ	左頚部リンパ節腫脹	頚部リンパ節腫脹
左頸部のリンパの腫物	左頚部リンパ節腫脹	頚部リンパ節腫脹
巨発達腫瘤	巨大腫瘤	腫瘤
巨脾症	脾腫	脾腫
差し込み	腹痛	腹痛症,腹壁痛,仙痛
差し迫ってる	頻拍	頻拍症
常に咳が出る	慢性咳嗽	慢性咳嗽
常識外れの行動	異常行動	異常行動
平熱より少し高い	微熱	微熱
平熱より少し高い体温	微熱	微熱
平衡感覚不調	歩行困難	歩行困難
幻	幻覚	幻覚
幻が見える	幻覚	幻覚
幻を見た	幻覚	幻覚
幻を見る	幻覚	幻覚
幻影	幻覚	幻覚
幻惑	めまい,幻覚	めまい,幻覚
幻覚	意識障害	意識障害
広範囲の粒状の影	びまん性粒状影	胸部異常陰影
府からみ	膨満	腹部膨満
座った状態での呼吸	起坐呼吸	起坐呼吸
座った状態で呼吸すること	起坐呼吸	起坐呼吸
座っての呼吸	起坐呼吸	起坐呼吸
座って息をする	起坐呼吸	起坐呼吸
弊害	構音障害	構音障害
弛張熱	弛張熱	弛張熱
弛緩	脱力	脱力感,筋脱力
弱熱	微熱	微熱
強いしびれなど	強直性痙攣	強直性痙攣
強い痛み	鈍痛	鈍痛
強い除脈	高度徐脈	徐脈
強く圧迫した後が浮腫む	圧痕浮腫	浮腫
強く押されてできた腫れ	圧痕性浮腫	浮腫
強く結ぶ	硬結	硬結
強張り	こわばり	こわばり
影	肺浸潤影,スリガラス状陰影	肺部異常陰影,胸部異常陰影
影がある	胸部異常陰影	胸部異常陰影
律動	寡動,振戦	行動緩慢,振戦
後ろ頭が痛い	後頭部痛	後頭部痛
後頚部硬直	項部硬直	項部硬直
後頭神経痛	後頭部痛	後頭部痛
後頭部が痛い	後頭部痛	後頭部痛
後頭部が硬い	項部硬直	項部硬直
後頭部の痛み	後頭部痛	後頭部痛
徐脈	徐脈	徐脈
徐脈性不整脈	徐脈,洞性徐脈	徐脈,洞徐脈
循環しないこと	循環不全	急性循環不全,末梢循環不全
循環器が悪い	循環不全	急性循環不全,末梢循環不全
循環器系がおかしい	循環不全	急性循環不全,末梢循環不全
循環器系の痛み	右胸部痛	側胸部痛
循環器系痛	左胸部痛	胸痛
循環性ショック	出血性ショック	出血性ショック
循環系のうごきがわるい	循環不全	急性循環不全,末梢循環不全
循環障害	循環不全	急性循環不全,末梢循環不全
微妙な発熱	微熱	微熱
微弱	頻脈	頻脈症,洞頻脈
微熱	弛張熱,熱感,発熱	弛張熱,ほてり,発熱
微量の出血	潜血	顕微鏡的血尿
心がわさわさ	悪心	悪心
心エコーに移った影	心陰影	胸部異常陰影
心不全	左胸部痛,心窩部不快感,末梢循環不全,突然死	胸痛,心窩部不快,末梢循環不全,突然死
心停止	呼吸停止	呼吸停止
心動作異常	心電図異常	心電図異常
心房細動	房室回帰性頻拍,頻脈性不整脈	頻拍症,頻脈性不整脈
心拍が100拍/分以上の規則正しい頻脈	洞性頻脈（どうせいじょうみゃく）	
心拍が早く	動悸	動悸
心拍が遅くなる	徐脈性不整脈	徐脈性不整脈
心拍の異常	心電図異常	心電図異常
心拍や脈拍がきわめてゆっくりであること	高度徐脈	徐脈
心拍数がはやくなる	頻脈性不整脈	頻脈性不整脈
心拍数が遅くなる不正脈	徐脈性不整脈	徐脈性不整脈
心拍数の増加	頻脈	頻脈症,洞頻脈
心拍数増加	動悸,頻脈	動悸,頻脈症,洞頻脈
心拡大	心陰影拡大	胸部異常陰影
心疾患	左下腿腫脹,血管雑音,悪心,心窩部不快感,全胸部痛,心電図異常,動悸発作	下腿腫脹,動脈性雑音,悪心,心窩部不快,心電図異常,動悸
心窩部不快感	心窩部不快感	心窩部不快
心筋の異常	心電図異常	心電図異常
心筋梗塞	全胸部痛,左前胸部痛,胸痛	前胸部痛,胸痛
心筋症	全胸部痛	
心肥大	心陰影拡大	胸部異常陰影
心肺停止	呼吸停止,多臓器不全	呼吸停止,多臓器不全
心臓から異音がする	心雑音	心雑音
心臓があおる	動悸発作	動悸
心臓がどきどきする	動悸	動悸
心臓がなんかおかしい	心窩部不快感	心窩部不快
心臓がばくばくする	動悸	動悸
心臓がドキドキする	動悸	動悸
心臓がドクドクしてきもちわるい	動悸	動悸
心臓がバクバク	動悸	動悸
心臓がバクバクする	動悸発作,動悸	動悸
心臓が動く早さで頭が痛くなる病気	拍動性頭痛	頭痛
心臓が悪い	悪心	悪心
心臓が早く動く	動悸	動悸
心臓が炙る	動悸	動悸
心臓が異常になる症状	動悸発作	動悸
心臓が痛い	心窩部痛,左胸痛,左胸部痛,胸痛	心窩部痛,胸痛
心臓が痛くなる	胸痛発作	胸痛
心臓に変な音	心雑音	心雑音
心臓に影	心陰影	胸部異常陰影
心臓に影がある	心陰影	胸部異常陰影
心臓に異常がある	心電図異常	心電図異常
心臓に異常でた	心電図異常	心電図異常
心臓のあたりの痛み	左胸部痛	胸痛
心臓のレントゲン像を拡大	心陰影拡大	胸部異常陰影
心臓のレントゲン写真	心陰影	胸部異常陰影
心臓のレントゲン写真で大きく映る	心陰影拡大	胸部異常陰影
心臓のレントゲン所見	心陰影	胸部異常陰影
心臓の下あたりが痛い	心窩部痛	心窩部痛
心臓の具合が悪い	循環不全	急性循環不全,末梢循環不全
心臓の影	心陰影	胸部異常陰影
心臓の影が大きくなる	心陰影拡大	胸部異常陰影
心臓の影が拡大する	心陰影拡大	胸部異常陰影
心臓の房室の脈が早い	房室回帰性頻拍	頻拍症
心臓の拍動数が異常に減少する状態	徐脈	徐脈
心臓の拡大レントゲン写真	心陰影拡大	胸部異常陰影
心臓の機能が働いていない	循環不全	急性循環不全,末梢循環不全
心臓の痛み	心窩部痛	心窩部痛
心臓の辺りがおかしい	心窩部不快感	心窩部不快
心臓の辺りが痛い	右胸痛,右前胸部痛,右季肋部痛,右側胸部痛	胸痛,前胸部痛,季肋部痛
心臓の雑音	心雑音	心雑音
心臓の音がおかしい	心雑音	心雑音
心臓の音がきつい	動悸	動悸
心臓の音に変な音が混じっている	心雑音	心雑音
心臓の音に混じる雑音	心雑音	心雑音
心臓の音に雑音が混ざる	心雑音	心雑音
心臓の鼓動が激しくなる	動悸発作	動悸
心臓の鼓動のグラフの異常	心電図異常	心電図異常
心臓の鼓動リズムが狂う	洞性頻脈（どうせいじょうみゃく）	
心臓付近が痛い	左胸部痛	胸痛
心臓付近に感じる痛み	心窩部痛	心窩部痛
心臓付近の痛み	左胸痛,左側胸部痛,左前胸部痛,胸痛	胸痛,側胸部痛,前胸部痛
心臓停止	突然死	突然死
心臓内の血液の逆流	房室回帰性頻拍	頻拍症
心臓拍動	動悸	動悸
心臓異常	動悸発作	動悸
心臓疾患	右前胸部痛,徐脈性不整脈	前胸部痛,徐脈性不整脈
心臓病	心陰影拡大,心陰影,心電図異常	胸部異常陰影,心電図異常
心臓痛	左胸部痛	胸痛
心臓発作	全胸部痛,動悸発作	動悸
心臓肥大	心陰影拡大	胸部異常陰影
心臓雑音	心雑音	心雑音
心部痛	動悸	動悸
心配停止	呼吸停止	呼吸停止
心電図	心陰影	胸部異常陰影
心電図が乱れる	心電図異常	心電図異常
心電図が正常でない	心電図異常	心電図異常
心電図に異常がある	心電図異常	心電図異常
心電図の波形がおかしい	心電図異常	心電図異常
心電図の異常	心電図異常	心電図異常
心電図波形の異常	心電図異常	心電図異常
心電図異常	心電図異常	心電図異常
心音がやたら感じる	動悸	動悸
心音に通常の音以外がある	心雑音	心雑音
心音に雑音が入る	心雑音	心雑音
忘っぽい	物忘れ	健忘症
忘れっぽい	物忘れ	健忘症
忘れやすい	物忘れ	健忘症
思い出せない	物忘れ	健忘症
思い出せなかったり覚えていられない	記憶障害	記憶障害
思い出せんがよ	記銘力障害	記銘力低下,記憶障害
思い過ごし	一過性意識障害	一過性意識障害
思うように動かないこと	こわばり	こわばり
思うように歩けない	歩行障害	歩行障害
思った事を言葉にできない	運動性失語	運動性失語症
怠い	倦怠感,全身倦怠感	倦怠感,全身倦怠感
急いで止血	活動性出血	出血
急なお腹の痛み	急性腹症	急性腹症
急なはらいた	急性腹症	急性腹症
急な失神	失神発作	失神
急な寒気と震え	悪寒戦慄	悪寒戦慄
急な腹痛	急性腹症	急性腹症
急な腹痛　	急性腹症	急性腹症
急に	突然死	突然死
急におなかが痛くなる	急性腹症	急性腹症
急にどうきがする	動悸発作	動悸
急にブルブル震えだす	痙攣発作	痙攣発作
急に亡くなる	突然死	突然死
急に意識が飛ぶ	失神発作	失神
急に死ぬ	突然死	突然死
急に病的に胸が痛い	胸痛発作	胸痛
急に目の前がまっくらになる	眼前暗黒感	眼前暗黒
急に胸が苦しくなる	胸痛発作	胸痛
急に脈が速くなる	頻脈性不整脈	頻脈性不整脈
急に腹が痛い	急性腹症	急性腹症
急性炎症	筋性防御	筋性防御
急性腹症	急性腹症	急性腹症
急性腹痛	急性腹症,腹痛発作	急性腹症,腹痛症
急死	突然死	突然死
急激腹痛	急性腹症	急性腹症
性器から血が出た	性器出血	性器出血
性器から血が出る	性器出血	性器出血
性器の出血	性器出血	性器出血
息	吐気	嘔気
息があがる	息切れ	息切れ
息がうまく吸えない	呼吸困難	呼吸困難
息がおかしい	起坐呼吸	起坐呼吸
息がしづらい	呼吸困難感,拘束性換気障害,呼吸苦,息切れ	呼吸麻痺,拘束性換気障害,呼吸促迫,呼吸困難,息切れ
息がしづらい感じがする	呼吸困難感	呼吸麻痺
息がしづらい感覚	呼吸困難感	呼吸麻痺
息がしにくい	呼吸困難感,呼吸困難	呼吸麻痺,呼吸困難
息がしにくいような気がする	呼吸困難感	呼吸麻痺
息ができない	呼吸困難,呼吸困難感,息切れ,呼吸筋麻痺,呼吸苦	呼吸困難,呼吸麻痺,息切れ,呼吸促迫,呼吸困難
息がない	呼吸停止,無呼吸	呼吸停止,無呼吸発作
息がスムーズにできない	呼吸苦	呼吸促迫,呼吸困難
息がハアハアすること	息切れ	息切れ
息が出来ない	呼吸困難,呼吸苦,呼吸困難感	呼吸困難,呼吸促迫,呼吸困難,呼吸麻痺
息が出来ない感じ	呼吸困難感	呼吸麻痺
息が出来なくなる	呼吸困難	呼吸困難
息が切ない	労作時呼吸困難感	労作時呼吸困難
息が切れる	息切れ,労作性呼吸困難	息切れ,発作性呼吸困難,労作時呼吸困難
息が吸えない	呼吸困難	呼吸困難
息が止まった	呼吸停止	呼吸停止
息が止まっている	無呼吸	無呼吸発作
息が止まる	呼吸停止	呼吸停止
息が続かない	労作時呼吸苦	労作時呼吸困難
息が苦しい	呼吸苦,呼吸困難,拘束性換気障害,呼吸困難感,労作時息切れ,息切れ,起坐呼吸,労作性呼吸困難,呼吸筋麻痺,低酸素血症,労作時呼吸困難感,呼吸停止,嚥下困難感,労作時呼吸苦	呼吸促迫,呼吸困難,呼吸困難,拘束性換気障害,呼吸麻痺,息切れ,起坐呼吸,発作性呼吸困難,労作時呼吸困難,低酸素血症,労作時呼吸困難,呼吸停止,嚥下困難
息が苦しい感じ	呼吸困難感	呼吸麻痺
息が苦しい感覚	呼吸困難感	呼吸麻痺
息が荒い	頻呼吸,息切れ	頻呼吸,息切れ
息が詰まる	呼吸困難,呼吸困難感	呼吸困難,呼吸麻痺
息していない	呼吸停止	呼吸停止
息してない	無呼吸,呼吸停止	無呼吸発作,呼吸停止
息しんどい	呼吸困難感	呼吸麻痺
息するのが難しい	呼吸困難感	呼吸麻痺
息をしていない	無呼吸,呼吸停止	無呼吸発作,呼吸停止
息をしていないこと	呼吸停止	呼吸停止
息をしてない	無呼吸	無呼吸発作
息をしない	無呼吸	無呼吸発作
息をすることが辛い状態	呼吸苦	呼吸促迫,呼吸困難
息をするとゼイゼイする	喘鳴	喘鳴
息をすると喉が鳴る	喘鳴	喘鳴
息をするのが苦しい	呼吸苦	呼吸促迫,呼吸困難
息をするのが苦しく感じる	呼吸困難感	呼吸麻痺
息をするのが難しい状態	呼吸困難	呼吸困難
息をするのが難しく感じる事	呼吸困難感	呼吸麻痺
息をする筋肉のまひ	呼吸筋麻痺	呼吸麻痺
息切れ	労作時呼吸困難,労作時息切れ,労作時呼吸苦,安静時呼吸困難,動悸,労作時呼吸困難感,労作性呼吸困難,呼吸困難,呼吸困難感,頻呼吸,動悸発作,喘鳴,呼吸苦,息切れ	労作時呼吸困難,息切れ,呼吸困難,動悸,発作性呼吸困難,労作時呼吸困難,呼吸麻痺,頻呼吸,喘鳴,呼吸促迫,呼吸困難
息切れがする	労作時息切れ	息切れ
息止まった	呼吸停止	呼吸停止
息継ぎが逆	吃逆	横隔膜痙攣症,しゃっくり
息苦	呼吸困難	呼吸困難
息苦しい	呼吸困難感,労作時呼吸困難感,呼吸困難,呼吸苦,息切れ,低酸素血症,拘束性換気障害,安静時呼吸困難,労作性呼吸困難,胸部不快感,労作時呼吸苦,胸部痛,労作時息切れ,右側胸部痛,胸部違和感	呼吸麻痺,労作時呼吸困難,呼吸困難,呼吸促迫,呼吸困難,息切れ,低酸素血症,拘束性換気障害,発作性呼吸困難,労作時呼吸困難,胸部不快感,胸痛
息苦しい　	呼吸困難	呼吸困難
息苦しい感じ	呼吸困難感	呼吸麻痺
息苦しい感じがする	呼吸困難感	呼吸麻痺
息苦しい感覚	呼吸困難感	呼吸麻痺
息苦しさ	労作時呼吸困難,呼吸困難感,呼吸苦,呼吸困難	労作時呼吸困難,呼吸麻痺,呼吸促迫,呼吸困難,呼吸困難
息詰まり	呼吸困難	呼吸困難
患部の発熱	熱感	ほてり
悪い心臓	悪心	悪心
悪寒	悪心,熱感,悪寒戦慄,発熱,悪寒,吐気,熱,吐き気	悪心,ほてり,悪寒戦慄,発熱,悪寒,嘔気
悪寒が走る	発熱	発熱
悪心	嘔気,悪心,吐き気	嘔気,悪心
悪性リンパ腫	腹部リンパ節腫大,左頚部リンパ節腫脹	リンパ節腫大,頚部リンパ節腫脹
悪性腫	腫瘤病変	腫瘤
悪性腫瘍	全身リンパ節腫脹	リンパ節腫大
悪玉コレステロールが高い	高LDH血症	
悪玉コレステロール値が高い	高LDH血症	
情報を正しく認可する能力が落ちている	記銘力低下	記銘力低下
惹き付け	痙攣	痙攣
意図しないで手足など動かせずしびれること	けいれん発作	てんかん様発作,痙攣発作,痙攣重積発作,全身痙攣発作
意図しない手足等の異常な痺れなど	痙攣	痙攣
意志に基づかない不合理な運動	不随意運動	不随意運動症
意思とは関係なく震える様子	振戦	振戦
意思に反して動く	不随意運動	不随意運動症
意欲がない	意識レベルの低下	意識障害
意識がおかしい	記憶障害,昏迷	記憶障害,昏迷
意識がおかしくなる	意識混濁	意識混濁
意識がとぶ	失神発作	失神
意識がない	意識障害,昏迷,一過性意識障害,意識混濁,意識レベルの低下	意識障害,昏迷,一過性意識障害,意識混濁
意識がない　	意識消失	意識消失
意識がなくなった	意識消失発作	眼前暗黒,虚脱,血管迷走神経性失神,失神,心臓性失神,卒倒,単純性失神,排尿性失神,労作性失神
意識がなくなっった	意識消失	意識消失
意識がなくなる	意識消失,意識混濁,意識障害	意識消失,意識混濁,意識障害
意識がはっきりしていない	意識レベルの低下	意識障害
意識がはっきりしない	意識レベル低下,意識障害	意識障害
意識がはっきりしない状態になっていく	意識レベルの低下	意識障害
意識がはっきりしなくなる	意識混濁	意識混濁
意識がぼんやりする	意識障害	意識障害
意識がもうろう	意識障害	意識障害
意識がもうろうとしている	意識混濁	意識混濁
意識がもうろうとする	意識混濁,意識障害	意識混濁,意識障害
意識が乏しい	意識レベルの低下	意識障害
意識が低い	意識レベル低下	意識障害
意識が低下している状態	意識混濁	意識混濁
意識が低下する	意識レベル低下	意識障害
意識が悪くなっている	意識レベル低下	意識障害
意識が曖昧	見当識障害,意識混濁	見当識障害,意識混濁
意識が曖昧になっている。	昏迷	昏迷
意識が朦朧	昏迷	昏迷
意識が朦朧とした状態	意識混濁	意識混濁
意識が朦朧としている	意識混濁	意識混濁
意識が朦朧とする	意識混濁,意識障害	意識混濁,意識障害
意識が混濁する	意識障害,意識レベル低下	意識障害
意識が無い	意識消失	意識消失
意識が無い状態	昏迷	昏迷
意識が無くなる	意識消失,意識障害	意識消失,意識障害
意識が薄れる	意識レベルの低下,昏迷	意識障害,昏迷
意識が遠くなる	意識レベル低下,意識レベルの低下	意識障害
意識が遠のく	意識レベルの低下,意識レベル低下	意識障害
意識が飛ぶ	一過性意識障害	一過性意識障害
意識しないで動く	不随意運動	不随意運動症
意識とは無関係の異常な手足の動き	けいれん	痙攣
意識とは関係なく体が硬直したり震える	痙攣	痙攣
意識ない	意識レベル低下	意識障害
意識なし	意識消失発作,意識レベル低下	眼前暗黒,虚脱,血管迷走神経性失神,失神,心臓性失神,卒倒,単純性失神,排尿性失神,労作性失神,意識障害
意識に関係なく動く	不随意運動	不随意運動症
意識の混濁	意識レベル低下,意識レベルの低下	意識障害
意識はあるが外部からの刺激に反応しない状態	昏迷	昏迷
意識もうろう	軽度意識障害,意識障害	意識障害
意識をなくす発作	意識消失発作	眼前暗黒,虚脱,血管迷走神経性失神,失神,心臓性失神,卒倒,単純性失神,排尿性失神,労作性失神
意識を一時的に失う	一過性意識障害	一過性意識障害
意識を失う	意識消失,意識消失発作,失神発作,意識障害	意識消失,眼前暗黒,虚脱,血管迷走神経性失神,失神,心臓性失神,卒倒,単純性失神,排尿性失神,労作性失神,失神,意識障害
意識を失った	意識障害	意識障害
意識を失っている状態	昏迷	昏迷
意識レベルが下がる	意識レベル低下	意識障害
意識レベルの低下	意識混濁,意識レベルの低下	意識混濁,意識障害
意識レベル上昇	意識レベル低下	意識障害
意識レベル低下	意識混濁,失神発作,意識障害	意識混濁,失神,意識障害
意識不明	意識混濁,昏迷,意識レベル低下,意識消失,意識消失発作,意識障害,一過性意識障害,呂律困難,呼吸停止,失神発作	意識混濁,昏迷,意識障害,意識消失,眼前暗黒,虚脱,血管迷走神経性失神,失神,心臓性失神,卒倒,単純性失神,排尿性失神,労作性失神,一過性意識障害,構音障害,呼吸停止,失神
意識不明状態	昏迷	昏迷
意識低下	記憶障害,意識混濁,意識レベル低下	記憶障害,意識混濁,意識障害
意識喪失	意識レベル低下,意識障害,意識混濁	意識障害,意識混濁
意識変容	意識障害	意識障害
意識失い発作が起こる	意識消失発作	眼前暗黒,虚脱,血管迷走神経性失神,失神,心臓性失神,卒倒,単純性失神,排尿性失神,労作性失神
意識委朦朧状態	意識レベルの低下	意識障害
意識朦朧	意識障害,意識混濁,意識レベルの低下,意識レベル低下,意識消失発作	意識障害,意識混濁,眼前暗黒,虚脱,血管迷走神経性失神,失神,心臓性失神,卒倒,単純性失神,排尿性失神,労作性失神
意識消失	意識消失	意識消失
意識消失発作	意識消失発作	眼前暗黒,虚脱,血管迷走神経性失神,失神,心臓性失神,卒倒,単純性失神,排尿性失神,労作性失神
意識混濁	意識障害,意識レベルの低下,昏迷,意識レベル低下	意識障害,昏迷
意識無し	意識レベル低下	意識障害
意識障害	意識レベルの低下,意識レベル低下,見当識障害,昏迷,意識消失発作,意識消失,記銘力低下,意識混濁,痙攣発作,失神発作,めまい	意識障害,見当識障害,昏迷,眼前暗黒,虚脱,血管迷走神経性失神,失神,心臓性失神,卒倒,単純性失神,排尿性失神,労作性失神,意識消失,記銘力低下,意識混濁,痙攣発作,失神,めまい
意識障害 	意識消失	意識消失
感じない	感覚障害	体感異常
感じることがおかしくなる	感覚障害	体感異常
感じ方がおかしい	感覚異常	感覚異常症
感想喉	乾性咳嗽	乾性咳
感染兆候	発赤腫脹	発赤
感覚おかしい	しびれ	しびれ感
感覚がおかしい	感覚障害,感覚異常,異常感覚	体感異常,感覚異常症,異常触覚,異常知覚
感覚がおかしくなる	感覚障害,異常感覚	体感異常,異常触覚,異常知覚
感覚がない	感覚鈍麻,感覚障害	感覚異常症,体感異常
感覚がわからない	感覚障害	体感異常
感覚が余りない	感覚鈍麻	感覚異常症
感覚が分からない	感覚障害	体感異常
感覚が変	感覚異常	感覚異常症
感覚が思うようにならない	感覚障害	体感異常
感覚が普通ではない	異常感覚	異常触覚,異常知覚
感覚が正常でないこと	感覚異常	感覚異常症
感覚が正常でない状態	感覚異常	感覚異常症
感覚が鈍い	感覚鈍麻	感覚異常症
感覚が鈍くなる	感覚鈍麻	感覚異常症
感覚が鈍くなること	感覚鈍麻	感覚異常症
感覚が鈍る	感覚鈍麻,感覚障害,痺れ,しびれ	感覚異常症,体感異常,しびれ感
感覚が鈍ること	感覚鈍麻	感覚異常症
感覚が麻痺する	感覚鈍麻	感覚異常症
感覚に異常がある	感覚異常	感覚異常症
感覚の低下	痺れ	しびれ感
感覚の異常	感覚異常	感覚異常症
感覚の鈍感さ	感覚鈍麻	感覚異常症
感覚不正	感覚鈍麻	感覚異常症
感覚低下	感覚鈍麻	感覚異常症
感覚機能障害	感覚異常	感覚異常症
感覚異常	感覚障害,異常感覚,知覚障害,痺れ	体感異常,異常触覚,異常知覚,知覚障害,しびれ感
感覚過敏	感覚障害	体感異常
感覚鈍感	感覚異常	感覚異常症
感覚障害	感覚異常,温痛覚障害,異常感覚,知覚障害,温痛覚低下,痺れ感,しびれ感,感覚障害	感覚異常症,温痛覚過敏,異常触覚,異常知覚,知覚障害,知覚鈍麻,しびれ感,体感異常
感覚麻痺	温痛覚障害,温痛覚低下,感覚鈍麻,異常感覚,感覚障害,しびれ	温痛覚過敏,知覚鈍麻,感覚異常症,異常触覚,異常知覚,体感異常,しびれ感
感触が鈍い	感覚異常	感覚異常症
慢心	脱力	脱力感,筋脱力
慢性疲労	全身倦怠感,倦怠感	全身倦怠感,倦怠感
慢性痛	疼痛	疼痛
慢性的なセキ	乾性咳嗽	乾性咳
慢性的な咳	慢性咳嗽	慢性咳嗽
慢性胃炎	心窩部不快感	心窩部不快
慣れ	むくみ	浮腫
成長期	高ＡＬＰ血症	高アルカリホスファターゼ血症
戻してしまう	嘔吐	嘔吐症
戻す	嘔吐	嘔吐症
手がしびれたり異常な動きする	痙攣発作	痙攣発作
手が震える	振戦,手指振戦	振戦,手指振戦
手のふるえ	手指振戦	手指振戦
手の指がふるえること	手指振戦	手指振戦
手の指が震える	手指振戦	手指振戦
手の指が震えること	手指振戦	手指振戦
手の震え	手指振戦,振戦	手指振戦,振戦
手や指が震える	手指振戦	手指振戦
手や指が震える症状	手指振戦	手指振戦
手先の震え	手指振戦	手指振戦
手指がふるえる	手指振戦	手指振戦
手指震え	手指振戦	手指振戦
手足がだるい	四肢脱力感,四肢浮腫	四肢脱力感,四肢浮腫
手足がの筋力が衰える	四肢筋力低下	四肢筋力低下
手足が動かない	四肢筋力低下	四肢筋力低下
手足が動きにくい	四肢脱力	四肢脱力
手足が脱力した感じ	四肢脱力感	四肢脱力感
手足が腫れている	四肢浮腫	四肢浮腫
手足が自由に動かせない	こわばり	こわばり
手足などがびりびりする	痺れ	しびれ感
手足などの感覚障害	知覚障害	知覚障害
手足にむくみがある	四肢浮腫	四肢浮腫
手足にチカラが入らない	四肢脱力	四肢脱力
手足に倦怠感	四肢筋力低下	四肢筋力低下
手足に力が入らない	四肢脱力,四肢脱力感,四肢筋力低下	四肢脱力,四肢脱力感,四肢筋力低下
手足に力が入らないこと	四肢脱力	四肢脱力
手足に力が入らない感じがする症状	四肢脱力感	四肢脱力感
手足に力入らん	四肢脱力	四肢脱力
手足に手袋をつけたように感じることがうとましい	感覚障害	体感異常
手足に脱力感があること	四肢脱力感	四肢脱力感
手足のむくみ	四肢浮腫	四肢浮腫
手足のむくみがひどい	四肢浮腫	四肢浮腫
手足の先の血の巡りが悪い	末梢循環不全	末梢循環不全
手足の先端の色が紫色になる	チアノーゼ	チアノーゼ
手足の力が入らない	四肢脱力,四肢筋力低下	四肢脱力,四肢筋力低下
手足の力が抜ける	四肢脱力	四肢脱力
手足の皮下組織に組織間液が大量にたまった状態	四肢浮腫	四肢浮腫
手足の筋力が低い	四肢筋力低下	四肢筋力低下
手足の筋力が低下	四肢筋力低下	四肢筋力低下
手足の筋力が弱くなること	四肢筋力低下	四肢筋力低下
手足の筋力が無くなる	四肢筋力低下	四肢筋力低下
手足の筋力が落ちる	四肢筋力低下	四肢筋力低下
手足の筋力が落ちること	四肢筋力低下	四肢筋力低下
手足の筋力の低下	四肢筋力低下	四肢筋力低下
手足の筋力低下	四肢筋力低下	四肢筋力低下
手足の脱力感	四肢脱力感,下肢脱力感,四肢脱力	四肢脱力感,下肢脱力感,四肢脱力
手足むくみ	四肢浮腫	四肢浮腫
手足倦怠感	四肢脱力感	四肢脱力感
手足浮腫	四肢浮腫	四肢浮腫
手足筋力低下	四肢脱力感,四肢筋力低下	四肢脱力感,四肢筋力低下
打ち身	皮下出血斑	皮下出血
打撲	圧痕浮腫	浮腫
抗体値の上昇	抗体価上昇	抗体価上昇
抜いてもすぐ腹に水が貯まる	難治性腹水	難治性腹水
披露しやすい	易疲労感	易疲労感
抵抗する力が上がってる	抗体価上昇	抗体価上昇
押さえつけて手を放したときに押した跡が残るむくみのこと	ｐｉｔｔｉｎｇ　ｅｄｅｍａ	浮腫
押さえると軽い痛みがある	軽度圧痛	圧痛
押されたときの痛み	圧痛	圧痛
押されたような痛み	圧痛	圧痛
押された感覚	前胸部圧迫感	胸部不快感
押された痛み	圧痛	圧痛
押されているように痛い	圧痛	圧痛
押されるような痛み	圧痛	圧痛
押される痛み	圧痛	圧痛
押したあとが残るむくみ	圧痕性浮腫	浮腫
押した時の痛み	圧痛	圧痛
押してへこむむくみ	圧痕性浮腫	浮腫
押し付けられて出来た跡	圧痕浮腫	浮腫
押すと少し痛い	軽度圧痛	圧痛
押すと少し痛みを感じる	軽度圧痛	圧痛
押すと痛い	圧痛,軽度圧痛	圧痛
拍動	動悸	動悸
拍動微弱	徐脈	徐脈
拒食	食欲不振,食欲低下,食思不振	食欲不振
拒食症	摂食不良,経口摂取不良	摂食機能障害
拘束性肺疾患	拘束性換気障害	拘束性換気障害
拘縮	固縮,こわばり	こわばり
持続痙攣	痙攣重積	痙攣重積発作
指の震えが止まらない	手指振戦	手指振戦
指先の震え	手指振戦	手指振戦
捻髪音	ｆｉｎｅ　ｃｒａｃｋｌｅｓ	湿性ラ音
排尿ができない	尿閉	尿閉
排尿が困難	排尿障害	排尿障害
排尿するのが難しい	排尿困難	排尿困難
排尿する時に痛い	排尿時痛	排尿痛
排尿の回数が多い	頻尿	多尿,頻尿症
排尿の痛み	排尿時痛	排尿痛
排尿不全	排尿困難	排尿困難
排尿回数が多い	多尿	多尿
排尿困難	尿閉,排尿障害,無尿状態	尿閉,排尿障害,無尿
排尿時の痛み	排尿時痛	排尿痛
排尿機能不全	排尿障害	排尿障害
排尿痛	排尿時痛	排尿痛
排尿障害	排尿困難,尿閉,無尿,排尿時痛,夜間頻尿,排尿障害	排尿困難,尿閉,無尿,排尿痛,夜間頻尿症,排尿障害
排泄	排尿障害	排尿障害
採血等での肝臓機能の数値が正常ではない	肝機能異常	肝機能検査異常
換気障害	拘束性換気障害	拘束性換気障害
摂食低下	食欲低下	食欲不振
摂食嚥下障害	経口摂取困難	経口摂取困難
摂食障害	摂食不良,食思不振,経口摂取困難,食欲不振	摂食機能障害,食欲不振,経口摂取困難
擦過傷	点状出血	点状出血
放心	虚脱	虚脱
数値が上昇しておかしい	高ＣＫ血症	高クレアチンキナーゼ血症
文章が喋れん	構語障害	構語障害
斑点	皮下出血	皮下出血
断続性ラ音	湿性ラ音,ｆｉｎｅ　ｃｒａｃｋｌｅｓ	湿性ラ音
新しいことが覚えられん	記銘力障害	記銘力低下,記憶障害
新しいことを覚えられない	記銘力低下	記銘力低下
新しい体験がわからない	記銘力障害	記銘力低下,記憶障害
新しく体験したことを覚えておくことができなくなる	記銘力障害	記銘力低下,記憶障害
新しく体験したことを記憶するのが苦手になる	記銘力低下	記銘力低下
新生児の黄疸	高ビリルビン血症	高ビリルビン血症
新生児黄疸	高ビリルビン血症	高ビリルビン血症
新生児黄胆	高ビリルビン血症	高ビリルビン血症
日の体温の動揺が1℃ 以上を示す熱型	弛張熱	弛張熱
日時場所がわからない	見当識障害	見当識障害
早い脈	頻脈	頻脈症,洞頻脈
昏睡	昏迷,意識障害,意識レベルの低下	昏迷,意識障害
昏睡状態	意識レベル低下,意識レベルの低下,意識障害	意識障害
易疲労感	易疲労感	易疲労感
普段から呼吸できない	安静時呼吸困難	呼吸困難
普段から胸が痛い	安静時胸痛	反復性胸痛,胸痛
普段より味がおかしくなる	味覚障害	味覚障害
普段より強い心臓の鼓動	動悸	動悸
普段柔らかい部分が固くなる	硬結	硬結
普通じゃない行動	異常行動	異常行動
普通でない感じ	異常感覚	異常触覚,異常知覚
普通でない感覚	異常感覚	異常触覚,異常知覚
普通と違った行動	異常行動	異常行動
暑い	熱,熱感	発熱,ほてり
暑気　熱っぽい	発熱	発熱
暖かい感覚の低下	温痛覚低下	知覚鈍麻
暖痛感	温痛	温痛覚過敏
暗くなってしまう	眼前暗黒感	眼前暗黒
暗く見える	眼前暗黒感	眼前暗黒
暴飲	多飲	多飲症
暴飲暴食	多飲	多飲症
最低体温が３７℃以上	弛張熱	弛張熱
朦朧	軽度意識障害,意識障害,意識レベルの低下,ふらつき	意識障害,めまい
朦朧、意識混濁	意識レベルの低下	意識障害
朦朧としている	意識混濁,意識レベル低下,意識障害	意識混濁,意識障害
朦朧とする	意識レベル低下,意識混濁	意識障害,意識混濁
末しょう循環障害	末梢循環不全	末梢循環不全
末梢の周りが悪い	末梢循環不全	末梢循環不全
末梢循環障害	末梢循環不全	末梢循環不全
末端の血の巡りが悪い	末梢循環不全	末梢循環不全
末端冷え性	末梢循環不全	末梢循環不全
本来取らない行動をする	異常行動	異常行動
柔らかい組織が炎症やうっ血充血などで硬くなること	硬結	硬結
柔らかい組織が硬くなること	硬結	硬結
栄養失調	摂食不良	摂食機能障害
極度の免疫低下による内臓機能低下	多臓器障害	多臓器不全
構音器に異常がないのに言語機能が低下すること	失語	失語症
構音障害	構語障害	構語障害
様々な臓器が機能不全	多臓器障害	多臓器不全
横っ腹いた	左側胸部痛	側胸部痛
横っ腹が痛い	側腹部痛,左下腹部痛,左側腹部痛,左上腹部痛	側腹部痛,下腹痛,臍下部痛,上腹部痛
横になっても息がしにくい	安静時呼吸困難	呼吸困難
横になると苦しく座位であれば呼吸が出来ること	起坐呼吸	起坐呼吸
横に大きくなる	体重増加	体重増加
横紋筋融解症	高ＣＫ血症	高クレアチンキナーゼ血症
横腹が痛い	左上腹部痛,右季肋部痛,側腹部痛	上腹部痛,季肋部痛,側腹部痛
横腹の痛み	左側腹部痛	側腹部痛
横隔膜	胸膜炎	胸膜炎
機能	耐糖能障害	耐糖能異常
機能不全	乾酪壊死	壊死
機能性胃腸症	心窩部不快感	心窩部不快
止血後に出血すること	再出血	出血
正しく発声ができない障害	構音障害	構音障害
正常でない行動	異常行動	異常行動
正常ではない	意識障害	意識障害
正常で規則的でありながらも弱くなるもの	洞性徐脈	洞徐脈
正常な判断ができない脳の機能	意識障害	意識障害
正常に喋れなくなる	呂律困難	構音障害
歩いたり動くと息が切れる	労作性呼吸困難	発作性呼吸困難,労作時呼吸困難
歩きづらい	歩行障害	歩行障害
歩きにくい	歩行困難,歩行障害,失調性歩行	歩行困難,歩行障害,失調性歩行
歩きにくいわぁ	歩行障害	歩行障害
歩きにくさ	歩行困難	歩行困難
歩きに支障が出る	歩行障害	歩行障害
歩き辛い	歩行障害,歩行困難	歩行障害,歩行困難
歩くことが難しい	歩行困難,歩行障害	歩行困難,歩行障害
歩くことが難しいこと	歩行困難	歩行困難
歩くことに難しさを感じる事	歩行障害	歩行障害
歩くために何かしら困難がある	歩行障害	歩行障害
歩くのが困難	歩行障害	歩行障害
歩くのが難しい	歩行困難,歩行障害	歩行困難,歩行障害
歩くのが難しい事	歩行困難	歩行困難
歩くのに問題が生じる	歩行障害	歩行障害
歩くのに障害がある	歩行障害	歩行障害
歩くのに難がある	歩行障害	歩行障害
歩くの難しい	歩行困難	歩行困難
歩く上での困難	歩行障害	歩行障害
歩く事が困難	歩行障害	歩行障害
歩く事が難しい	歩行困難	歩行困難
歩く事が難しい状態	歩行困難	歩行困難
歩く事に障害がある	歩行障害	歩行障害
歩く機能が損なわれた状態	歩行障害	歩行障害
歩けない	歩行困難,歩行障害,失調性歩行,ふらつき	歩行困難,歩行障害,失調性歩行,めまい
歩けなくなる	歩行困難,歩行障害	歩行困難,歩行障害
歩けへん	歩行困難	歩行困難
歩行ができない	歩行困難	歩行困難
歩行するのに難しい	歩行障害	歩行障害
歩行不振	ふらつき	めまい
歩行不能	歩行困難	歩行困難
歩行困難	失調性歩行,歩行障害,下肢脱力	失調性歩行,歩行障害,下肢脱力感
歩行障害	失調性歩行,歩行困難	失調性歩行,歩行困難
歯茎の腫れ	左頚部リンパ節腫脹	頚部リンパ節腫脹
死にそう	多臓器不全	多臓器不全
死に近い内臓障害	多臓器障害	多臓器不全
死ぬ	壊死	壊死
死ぬほど痛い	激痛	疼痛
死んだ	呼吸停止	呼吸停止
死亡	呼吸停止	呼吸停止
死因　免疫が極度に低下して死に至る	多臓器不全	多臓器不全
残尿	尿閉	尿閉
毛細管出血	点状出血	点状出血
毛細血管レベルで血管の破綻	肺胞出血	肺胞出血
気がもうろう	意識混濁	意識混濁
気が抜ける	脱力	脱力感,筋脱力
気が抜ける状態	脱力	脱力感,筋脱力
気が無くなる症状が出る	意識消失発作	眼前暗黒,虚脱,血管迷走神経性失神,失神,心臓性失神,卒倒,単純性失神,排尿性失神,労作性失神
気が狂った	異常行動	異常行動
気が触れる	異常行動	異常行動
気が遠くなる	意識消失,意識混濁	意識消失,意識混濁
気だるい	倦怠感,脱力感,全身倦怠感,脱力	倦怠感,脱力感,全身倦怠感,脱力感,筋脱力
気だるい　	倦怠感	倦怠感
気だるい状態	全身倦怠感	全身倦怠感
気だるさ	脱力,全身倦怠感	脱力感,筋脱力,全身倦怠感
気を失いかけ	意識レベルの低下	意識障害
気を失いかける	意識レベルの低下	意識障害
気を失う	意識消失,失神発作,意識消失発作,一過性意識障害,意識障害	意識消失,失神,眼前暗黒,虚脱,血管迷走神経性失神,失神,心臓性失神,卒倒,単純性失神,排尿性失神,労作性失神,一過性意識障害,意識障害
気を失う、朦朧	意識障害	意識障害
気を失う発作	失神発作	失神
気分が悪い	悪心	悪心
気失いそう	意識レベル低下	意識障害
気怠さ	倦怠感	倦怠感
気持ちが悪い	吐き気,悪心,胃部不快感	嘔気,悪心,腹部不快感
気持ち悪い	悪心,嘔気,吐気,吐き気,悪心嘔吐,上腹部不快感,嘔吐,嘔気嘔吐	悪心,嘔気,悪心,嘔吐症,腹部不快感,嘔吐症,嘔気,嘔吐症
気持ち悪いかんじ	異常感覚	異常触覚,異常知覚
気持ち悪くて吐いてしまう	悪心嘔吐	悪心,嘔吐症
気持ち悪くて吐く	悪心嘔吐,嘔気嘔吐	悪心,嘔吐症,嘔気,嘔吐症
気管支が浮き彫りに見えること	気管支透亮像	胸部異常陰影
気管支が狭くなっていて呼吸しにくい状態	閉塞性換気障害	閉塞性換気障害
気管支が狭くなって一気に息を吐き出すことができないこと	閉塞性換気障害	閉塞性換気障害
気管支ぜんそくの音	喘鳴	喘鳴
気管支などの空気の通り道が塞がってうまく呼吸できない症状	閉塞性換気障害	閉塞性換気障害
気管支の画像診断	気管支透亮像	胸部異常陰影
気管支喘息	喘鳴	喘鳴
気管支炎	気管支透亮像	胸部異常陰影
気絶	意識消失発作,一過性意識障害,意識消失,意識障害,失神発作,意識レベルの低下,意識レベル低下	眼前暗黒,虚脱,血管迷走神経性失神,失神,心臓性失神,卒倒,単純性失神,排尿性失神,労作性失神,一過性意識障害,意識消失,意識障害,失神
気絶した	意識消失発作	眼前暗黒,虚脱,血管迷走神経性失神,失神,心臓性失神,卒倒,単純性失神,排尿性失神,労作性失神
気絶寸前	意識混濁	意識混濁
気絶発作	失神発作	失神
気道が狭い時に出る音	喘鳴	喘鳴
気道に分泌物がある場合空気が気管支を通過して水泡が破れて生じる異常な呼吸音	湿性ラ音	湿性ラ音
気道出血	喀血	喀血
水がか貯まっとる	胸腹水	腹水症
水がたまる	腹水,胸腹水	腹水症
水が溜まる	大量腹水,膵性胸水,腹水貯留,胸腹水,腹水	腹水症,胸水検査異常
水っ腹	大量腹水	腹水症
水ぶくれ	腹水,嚢胞性腫瘤,腹水貯留,浮腫,血性腹水	腹水症,腫瘤,浮腫,血性腹水
水をよく飲み色の薄い尿をよく出す	多飲多尿	多飲症,多尿
水を飲むことがやめられなくなる	多飲	多飲症
水中毒	多飲	多飲症
水分	腹水	腹水症
水分の取りすぎ	多飲	多飲症
水分の取りすぎで沢山おしっこが出る	多飲多尿	多飲症,多尿
水分の摂り過ぎて尿が多く出る	多飲多尿	多飲症,多尿
水分をあまり伴わない乾いた咳	乾性咳	乾性咳
水分を多く取り、尿が多いこと	多飲多尿	多飲症,多尿
水分を過剰にとる	多飲	多飲症
水分不足	経口摂取不良	摂食機能障害
水分摂取過剰	多飲	多飲症
水分摂取過剰からくる頻尿	多飲多尿	多飲症,多尿
水分補給症	発汗過多	多汗症
水泡	浮腫,粘膜浮腫	浮腫
水泡音	湿性ラ音	湿性ラ音
水疱瘡	皮疹	発疹
水腫	大量腹水	腹水症
汗いっぱい出る事	発汗過多	多汗症
汗かき	発汗過多	多汗症
汗がいっぱい出る	発汗過多	多汗症
汗がたくさんでる	発汗過多	多汗症
汗がたくさん出る	発汗過多	多汗症
汗が出る	盗汗,発汗過多	寝汗,多汗症
汗が出過ぎ	発汗過多	多汗症
汗が多い	発汗過多	多汗症
汗が多すぎる	発汗過多	多汗症
汗だく	発汗過多	多汗症
汗だくだく	発汗過多	多汗症
汗っかき	発汗過多	多汗症
汗のかきすぎ	発汗過多	多汗症
汗の出る状態の一種	盗汗	寝汗
汗をかきすぎる	発汗過多	多汗症
汗をたくさんかく	発汗過多	多汗症
汚い痰	膿性痰	膿性痰
決まった時間に熱が出る	周期性発熱	発熱
沢山のリンパの病気	多発リンパ節腫脹	リンパ節腫大
沢山出来る塊	多発腫瘤,多発性腫瘤	腫瘤
沢山飲む	多飲	多飲症
治すのが難しい腹に水がたまる症状	難治性腹水	難治性腹水
治りにくい腹水	難治性腹水	難治性腹水
泌尿困難	尿閉	尿閉
注意不足	意識レベル低下	意識障害
洞性徐脈	徐脈	徐脈
洞頻脈	洞性頻脈（どうせいじょうみゃく）	
流血	出血	出血
流血による異常	出血性ショック	出血性ショック
浅い呼吸	頻呼吸	頻呼吸
浮いているようなめまい	浮動性めまい	めまい
浮く	むくみ	浮腫
浮腫	ｐｉｔｔｉｎｇ　ｅｄｅｍａ,むくみ,圧痕浮腫,顔面浮腫,両下腿浮腫,両下肢浮腫,全身性浮腫,膵性胸水,リンパ節腫脹,下肢浮腫,全身浮腫	浮腫,顔面浮腫,下腿浮腫,下肢浮腫,全身性浮腫,胸水検査異常,リンパ節腫大
浮腫み	浮腫性変化,圧痕性浮腫,圧痕浮腫,顔面浮腫,浮腫,全身浮腫	浮腫,顔面浮腫,全身性浮腫
浮腫み　	浮腫	浮腫
浮腫みが現れる	浮腫性変化	浮腫
浮腫むことによって形が変わってしまう	浮腫性変化	浮腫
浸潤陰影	胸部異常影	胸部異常陰影
消化不良	胃部不快感,摂食不良	腹部不快感,摂食機能障害
消化管の病気	心窩部不快感	心窩部不快
液体がたまる	嚢胞性腫瘤	腫瘤
液体のかたまりができる	嚢胞性腫瘤	腫瘤
淡いすりガラスのような陰影	スリガラス陰影	胸部異常陰影
淡い影	スリガラス様陰影	胸部異常陰影
淡白が出る	高度蛋白尿	蛋白尿
混乱	意識混濁	意識混濁
混濁	意識消失,昏迷	意識消失,昏迷
混迷	軽度意識障害	意識障害
渇き	口渇感,口渇	口渇症
渇く	口渇	口渇症
減量	体重減少	体重減少
温かさを感じない	温痛覚障害	温痛覚過敏
温まると痛い	温痛	温痛覚過敏
温めると痛い	温痛	温痛覚過敏
温めると痛むこと	温痛	温痛覚過敏
温度が感じにくい	温痛覚低下	知覚鈍麻
温度と痛み	温痛	温痛覚過敏
温度と痛みが感じにくい	温痛覚低下	知覚鈍麻
温度と痛みの感覚が低下	温痛覚低下	知覚鈍麻
温度や痛みが感じられない	温痛覚低下	知覚鈍麻
温度や痛みの感じ方がおかしい	温痛覚障害	温痛覚過敏
温度や痛みを感じにくい	感覚鈍麻	感覚異常症
温度を感じない	温痛覚障害	温痛覚過敏
温度感じ方の低下	温痛覚低下	知覚鈍麻
温痛覚	温痛	温痛覚過敏
温痛覚異常	温痛覚障害	温痛覚過敏
湿しん	皮膚黄染,粘膜発赤	黄疸,発赤
湿ったような咳	湿性咳嗽	湿性咳,慢性咳嗽
湿ったセキ	湿性咳嗽	湿性咳,慢性咳嗽
湿った呼吸時異常音	湿性ラ音	湿性ラ音
湿った咳	湿性咳嗽	湿性咳,慢性咳嗽
湿った所で出る咳	湿性咳嗽	湿性咳,慢性咳嗽
湿性咳	湿性咳嗽	湿性咳,慢性咳嗽
湿性咳嗽	湿性咳嗽	湿性咳,慢性咳嗽
湿疹	皮疹,丘疹,粒状陰影,発赤,発疹,痂皮,紅色丘疹,粘膜発赤,点状出血,黄疸	発疹,丘疹,胸部異常陰影,発赤,痂皮,紅色丘疹,点状出血,黄疸
湿疹ができる	発疹	発疹
満腹	腹満,腹満感,膨満,腹部膨満感	腹部膨満
満腹感	腹満感,腹部膨満感,胸部違和感	腹部膨満,胸部不快感
溢血点	点状出血	点状出血
漏らす	多尿	多尿
潜血	尿潜血	顕微鏡的血尿
潰れた	圧痛	圧痛
潰瘍	左上腹部痛	上腹部痛
激しい傷み	激痛	疼痛
激しい痛さ	激痛	疼痛
激しい痛み	激痛	疼痛
激しい腹痛	急性腹症	急性腹症
激しく震える	痙攣	痙攣
激やせ	体重減少	体重減少
激痛	痛み	疼痛
濁ったような影	スリガラス影	胸部異常陰影
濁った尿	褐色尿	ビリルビン尿
濁った尿が出ること	褐色尿	ビリルビン尿
濁音	心雑音	心雑音
濃い尿	褐色尿	ビリルビン尿
濃い痰	膿性痰	膿性痰
濃い色の尿	褐色尿	ビリルビン尿
濃度の高い淡白がでた尿	高度蛋白尿	蛋白尿
濃度過多	高ビリルビン血症	高ビリルビン血症
火照り	熱感	ほてり
炎症	発赤腫脹,温痛,粘膜発赤,頚部リンパ節腫脹,発熱	発赤,温痛覚過敏,頚部リンパ節腫脹,発熱
炭水化物分解酵素が血液中に多く含まれる症状	高アミラーゼ血症	高アミラーゼ血症
炭酸が濃すぎる	高炭酸ガス血症	高炭酸ガス血症
炭酸ガスを吸ったことによる中毒	高炭酸ガス血症	高炭酸ガス血症
炭酸ガスナルコーシス	CO２ナルコーシス	
点々した出血	点状出血	点状出血
点々とした皮下出血	点状出血	点状出血
点々に出血する	点状出血	点状出血
点のようなに血がでる	点状出血	点状出血
点在する出血	点状出血	点状出血
無し	四肢筋力低下	四肢筋力低下
無力	下肢脱力,意識レベル低下	下肢脱力感,意識障害
無力感	四肢脱力,脱力感	四肢脱力,脱力感
無動	寡動	行動緩慢
無呼吸	安静時呼吸困難,呼吸停止,労作性呼吸困難,労作時呼吸苦	呼吸困難,呼吸停止,発作性呼吸困難,労作時呼吸困難,労作時呼吸困難
無呼吸Syn	呼吸困難感	呼吸麻痺
無呼吸症	安静時呼吸困難	呼吸困難
無呼吸症候群	無呼吸	無呼吸発作
無尿	乏尿,無尿	乏尿,無尿
無尿症	無尿状態	無尿
無意識	意識レベルの低下	意識障害
無意識な体の震え	振戦	振戦
無意識に動く	不随意運動	不随意運動症
無意識運動	不随意運動	不随意運動症
無感覚	しびれ感	しびれ感
無気力	虚脱,脱力,脱力感,倦怠感	虚脱,脱力感,筋脱力,脱力感,倦怠感
無気力感	脱力感	脱力感
無気力症候群	脱力感	脱力感
無痛症	温痛覚障害	温痛覚過敏
無食	食思不振	食欲不振
焦点がぼやける	見当識障害	見当識障害
熱	熱感,熱発,高熱,発熱,弛張熱,不明熱,微熱	ほてり,発熱,高熱,弛張熱,不明熱,微熱
熱あつ	発熱	発熱
熱い	発熱,熱感	発熱,ほてり
熱い冷たいを感じられない	温痛覚低下	知覚鈍麻
熱い痛いがわからなくなる	温痛覚障害	温痛覚過敏
熱い痛み	温痛	温痛覚過敏
熱がある	発熱,高熱,微熱,熱発	発熱,高熱,微熱
熱があるような感じ	微熱	微熱
熱があるような気がする	熱感	ほてり
熱がでた	発熱	発熱
熱がでる	発熱	発熱
熱が出た	発熱,熱発	発熱
熱が出たが原因がわからない	不明熱	不明熱
熱が出ている	発熱	発熱
熱が出る	発熱,熱発,周期性発熱,悪寒,微熱	発熱,悪寒,微熱
熱が少し高い	微熱	微熱
熱が続く	弛張熱	弛張熱
熱が高い	高熱	高熱
熱く感じる症状	熱感	ほてり
熱さ	熱	発熱
熱さの感覚	熱感	ほてり
熱さや痛みの感覚が鈍い	温痛覚障害	温痛覚過敏
熱っぽい	熱感,微熱,弛張熱,温痛,発熱,不明熱	ほてり,微熱,弛張熱,温痛覚過敏,発熱,不明熱
熱っぽい感じ	熱感	ほてり
熱っぽさ	熱感	ほてり
熱でおでこが焼ける	高熱	高熱
熱のある感覚	熱感	ほてり
熱の時の寒気	悪寒	悪寒
熱まではいかなくても平熱よりは少し高い熱のこと	微熱	微熱
熱を出す	発熱	発熱
熱中症	弛張熱,熱感	弛張熱,ほてり
熱出た	弛張熱,発熱	弛張熱,発熱
熱感	熱感	ほてり
熱気味	熱発	発熱
熱病	発熱	発熱
熱発	発熱,熱発,周期性発熱,弛張熱,熱,微熱	発熱,弛張熱,微熱
片側性下肢腫脹	左下腿腫脹	下腿腫脹
片腹痛い	側腹部痛	側腹部痛
片頭痛	拍動性頭痛	頭痛
物が食べたかない	食欲低下	食欲不振
物が食べられない	経口摂取不良	摂食機能障害
物の認識ができない	記銘力障害	記銘力低下,記憶障害
物を忘れる事	物忘れ	健忘症
物を飲み込みにくい	嚥下困難感	嚥下困難
物を飲み込むのが困難な状態	嚥下障害	嚥下障害
物を飲み込むのが難しい	嚥下困難	嚥下困難
物事を思い出せない	物忘れ	健忘症
物事を正しく認識できない症状	知覚障害	知覚障害
物事を覚えていることが難しい状態	記憶障害	記憶障害
物事判断できない	見当識障害	見当識障害
物凄くいたい	激痛	疼痛
物忘れ	記憶障害,記銘力障害,記銘力低下,失語症,運動性失語,軽度意識障害	記憶障害,記銘力低下,記憶障害,記銘力低下,失語症,運動性失語症,意識障害
物忘れが激しい	記憶障害	記憶障害
物忘れしやすい	記憶障害	記憶障害
物忘れしやすくなった	記銘力低下	記銘力低下
物覚えがおかしい	知覚障害	知覚障害
物覚えがひどく悪い	記憶障害	記憶障害
特になし	喀痰,浮腫	喀痰,浮腫
特定のウイルスやアレルゲンなどに反応する抗体の程度のう目安となる数値が上昇すること	抗体価上昇	抗体価上昇
狭心症	胸部絞扼感,心陰影拡大,房室回帰性頻拍,左胸痛,安静時胸痛,胸痛発作,前胸部圧迫感	胸部不快感,胸部異常陰影,頻拍症,胸痛,反復性胸痛,胸痛
猫舌の逆	温痛覚低下	知覚鈍麻
現実にないもの	幻覚	幻覚
現実にはないものが見えること	幻覚	幻覚
理由なく急に死ぬ	突然死	突然死
生殖器から血が出ること	性器出血	性器出血
生殖機からの出血	性器出血	性器出血
生理	性器出血	性器出血
甲状腺機能低下	高ＣＫ血症	高クレアチンキナーゼ血症
異が痛い	上腹部痛	上腹部痛
異常な	蛋白細胞解離	髄液蛋白細胞数解離
異常なんですけど	異常感覚	異常触覚,異常知覚
異常な刺激	痛み	疼痛
異常な呼吸音	湿性ラ音	湿性ラ音
異常な呼吸音がする症状	湿性ラ音	湿性ラ音
異常な図形	心電図異常	心電図異常
異常な声	嗄声	嗄声
異常な心音	心雑音	心雑音
異常な水分摂取	多飲	多飲症
異常な汗の量	発汗過多	多汗症
異常な行動をする	異常行動	異常行動
異常動作	異常行動	異常行動
異常呼吸	頻呼吸	頻呼吸
異常影	空洞影	胸部異常陰影
異常心電図	心電図異常	心電図異常
異常心電図波形	心電図異常	心電図異常
異常感覚	感覚障害,異常感覚,感覚異常	体感異常,異常触覚,異常知覚,感覚異常症
異常知覚	知覚障害	知覚障害
異常肺静脈が三日月刀のように見えること	肺結節影	肺部異常陰影
異常運動	不随意運動	不随意運動症
異常陰影	胸部異常影	胸部異常陰影
疝痛発作	腹痛発作	腹痛症
疲れ	疲労感,全身倦怠感,易疲労感,倦怠感,虚脱,四肢筋力低下,脱力感,労作時息切れ	疲労感,全身倦怠感,易疲労感,倦怠感,虚脱,四肢筋力低下,脱力感,息切れ
疲れからきつい	意識レベルの低下	意識障害
疲れからくる息切れ	労作時息切れ	息切れ
疲れが取れない	疲労感	疲労感
疲れが溜まる	疲労感	疲労感
疲れた	疲労感,倦怠感,脱力感	疲労感,倦怠感,脱力感
疲れた感じ	疲労感	疲労感
疲れた状態	疲労感	疲労感
疲れている	疲労感	疲労感
疲れている感覚	疲労感	疲労感
疲れて息苦しい	労作性呼吸困難	発作性呼吸困難,労作時呼吸困難
疲れの症状	疲労感	疲労感
疲れやすい	易疲労感,疲労感	易疲労感,疲労感
疲れやすく感じる	易疲労感	易疲労感
疲れやすさ	易疲労感	易疲労感
疲れる	疲労感,易疲労感	疲労感,易疲労感
疲れを感じる	疲労感	疲労感
疲れ具合	疲労感	疲労感
疲れ気味	疲労感	疲労感
疲労	高乳酸血症,全身倦怠感,倦怠感,脱力感,脱力,むくみ,労作時胸痛,易疲労感,虚脱,息切れ	高乳酸血症,全身倦怠感,倦怠感,脱力感,脱力感,筋脱力,浮腫,反復性胸痛,胸痛,易疲労感,虚脱,息切れ
疲労困憊	虚脱,疲労感,全身倦怠感	虚脱,疲労感,全身倦怠感
疲労性不正呼吸	労作性呼吸困難	発作性呼吸困難,労作時呼吸困難
疲労感	倦怠感,脱力感,易疲労感	倦怠感,脱力感,易疲労感
疲弊感	疲労感	疲労感
疲弊衰弱	虚脱	虚脱
疼く	鈍痛	鈍痛
疼くような痛み	疼痛	疼痛
疼痛	痛み,激痛,温痛,しびれ,下肢疼痛,全身痛,頭痛	疼痛,温痛覚過敏,しびれ感,全身痛,頭痛
病気	両側肺門リンパ節腫脹	両側肺門リンパ節腫脹
病気の時にかく寝汗	盗汗	寝汗
痒いブツブツ	発赤	発赤
痒み	皮疹	発疹
痒みボロ	皮疹	発疹
痒みボロ　	発疹	発疹
痙攣	不随意運動,けいれん,痙攣発作,けいれん発作,しびれ,痙攣重積状態,痙攣,しびれ感	不随意運動症,痙攣,痙攣発作,てんかん様発作,痙攣発作,痙攣重積発作,全身痙攣発作,しびれ感,痙攣重積発作
痙攣がおこる	痙攣発作	痙攣発作
痙攣がひどくなる	痙攣重積状態	痙攣重積発作
痙攣が続いている症状	痙攣重積	痙攣重積発作
痙攣が続く	痙攣重積	痙攣重積発作
痙攣が起きる	けいれん発作,痙攣発作	てんかん様発作,痙攣発作,痙攣重積発作,全身痙攣発作,痙攣発作
痙攣が重い状態	痙攣重積	痙攣重積発作
痙攣が頻発する	痙攣重積	痙攣重積発作
痙攣しとる	けいれん発作	てんかん様発作,痙攣発作,痙攣重積発作,全身痙攣発作
痙攣する	痙攣発作,痺れ,しびれ感	痙攣発作,しびれ感
痙攣をおこす	痙攣発作	痙攣発作
痙攣を伴う発作	痙攣発作	痙攣発作
痙攣状態	けいれん発作	てんかん様発作,痙攣発作,痙攣重積発作,全身痙攣発作
痙攣発作	痙攣重積,全身性痙攣	痙攣重積発作,全身痙攣
痙攣発作が30分以上持続すること	痙攣重積	痙攣重積発作
痙攣発作を反復し発作間欠期にも意識が回復しない状態が30分以上続くこと	痙攣重積	痙攣重積発作
痙攣麻痺	痙攣重積	痙攣重積発作
痛い	痛み,疼痛,鈍痛,しびれ,激痛,圧痛	疼痛,鈍痛,しびれ感,圧痛
痛いわぁ	痛み	疼痛
痛い病	全身痛	全身痛
痛すぎる	激痛	疼痛
痛み	疼痛,鈍痛,圧痛,右季肋部痛,癌性疼痛	疼痛,鈍痛,圧痛,季肋部痛,癌性疼痛
痛みがある	圧痛	圧痛
痛みがはげしい	激痛	疼痛
痛みが感じにくい	鈍痛,温痛覚低下	鈍痛,知覚鈍麻
痛みます	全身痛	全身痛
痛みや熱さが鈍る	温痛覚低下	知覚鈍麻
痛痒い	スリガラス状陰影	胸部異常陰影
痛苦しい	リンパ節腫大,心窩部痛,労作時胸痛	リンパ節腫大,心窩部痛,反復性胸痛,胸痛
痛覚障害	温痛覚障害	温痛覚過敏
痛風	高乳酸血症,癌性疼痛,下肢疼痛	高乳酸血症,癌性疼痛,疼痛
痣	皮下出血,出血斑	皮下出血,斑状出血
痩せ	体重減少	体重減少
痩せた	体重減少	体重減少
痩せてきた	体重減少	体重減少
痩せる	体重減少	体重減少
痩身	体重減少	体重減少
痰	喀痰,膿性痰	喀痰,膿性痰
痰がからまない咳	乾性咳	乾性咳
痰がからむ	膿性痰,喀痰	膿性痰,喀痰
痰がでる	喀痰	喀痰
痰がらみの咳	湿性咳嗽	湿性咳,慢性咳嗽
痰が出る	喀痰,膿性痰	喀痰,膿性痰
痰が出る咳	湿性咳嗽	湿性咳,慢性咳嗽
痰が濃い	膿性痰	膿性痰
痰が絡んだ咳	湿性咳嗽	湿性咳,慢性咳嗽
痰に血がまざる	血痰	血痰
痰に血がまじる	血痰	血痰
痰に血が混ざる	血痰	血痰
痰に血が混じっている	血痰	血痰
痰に血が混じる	血痰	血痰
痰のからんだ咳	湿性咳嗽	湿性咳,慢性咳嗽
痰の出ない咳	乾性咳嗽	乾性咳
痰の絡んだ重たい咳	湿性咳嗽	湿性咳,慢性咳嗽
痰をはく	喀痰	喀痰
痰をはくこと	喀痰	喀痰
痰を出すこと	喀痰	喀痰
痰を吐く	喀痰	喀痰
痰咳	喘鳴	喘鳴
痰状の血液	血痰	血痰
痴呆	記憶障害,記銘力障害,軽度意識障害,物忘れ	記憶障害,記銘力低下,記憶障害,意識障害,健忘症
痴呆症	物忘れ,見当識障害	健忘症,見当識障害
痺れ	感覚障害,痺れ感,異常感覚,痺れ,疼痛,感覚鈍麻,痙攣	体感異常,しびれ感,異常触覚,異常知覚,疼痛,感覚異常症,痙攣
痺れる	痺れ感,しびれ	しびれ感
痺れる感じ	痺れ感	しびれ感
痺れを感じる	痺れ感	しびれ感
瘤	巨大腫瘤,腫瘤	腫瘤
瘤がたくさんできている	多発性腫瘤,多発腫瘤	腫瘤
瘤ができること	嚢胞性腫瘤	腫瘤
瘤が出来ている	腫瘤病変,皮下腫瘤,巨大腫瘤	腫瘤,皮下腫瘤
瘤が大きくなっている	腫瘤形成	腫瘤
瘤の影が見える	腫瘤像	腫瘤
瘤形成	腫瘤形成	腫瘤
癌	腫瘤像,腫大リンパ節,リンパ節腫脹,腫瘍性病変,腫瘤	腫瘤,リンパ節腫大,-1
癌からくる耐え難い痛み	癌性疼痛	癌性疼痛
癌による体の痛み	癌性疼痛	癌性疼痛
癌による痛み	癌性疼痛	癌性疼痛
癌の痛み	癌性疼痛	癌性疼痛
癌化	浮腫性変化	浮腫
癌要因病変	腫瘍性病変	-1
癌陽性の可能性	ＣＥＡ高値	ＣＥＡ高値
癲癇	意識消失発作	眼前暗黒,虚脱,血管迷走神経性失神,失神,心臓性失神,卒倒,単純性失神,排尿性失神,労作性失神
発作	痙攣,けいれん発作,動悸発作,けいれん,痙攣重積状態,胸部圧迫感,呼吸筋麻痺,痙攣発作	痙攣,てんかん様発作,痙攣発作,痙攣重積発作,全身痙攣発作,動悸,痙攣重積発作,胸内苦悶,呼吸麻痺,痙攣発作
発作がでる	痙攣発作	痙攣発作
発作を起こす	痙攣発作	痙攣発作
発作性上室性頻拍	房室回帰性頻拍	頻拍症
発作的に意識が失われる	意識消失発作	眼前暗黒,虚脱,血管迷走神経性失神,失神,心臓性失神,卒倒,単純性失神,排尿性失神,労作性失神
発作的に意識を失う	意識消失発作	眼前暗黒,虚脱,血管迷走神経性失神,失神,心臓性失神,卒倒,単純性失神,排尿性失神,労作性失神
発声困難	呂律困難	構音障害
発声発語障害	構音障害	構音障害
発汗	盗汗	寝汗
発汗多少	発汗過多	多汗症
発汗多量	発汗過多	多汗症
発熱	高熱,熱発,弛張熱,熱,周期性発熱,不明熱,熱感,微熱,頭痛	高熱,発熱,弛張熱,不明熱,ほてり,微熱,頭痛
発熱時の寒気	悪寒	悪寒
発疹	皮疹,丘疹,紅色丘疹,発赤,周期性発熱,発疹,出血斑	発疹,丘疹,紅色丘疹,発赤,発熱,斑状出血
発疹が出る	発赤	発赤
発疹が出来ている	丘疹	丘疹
発達障害、痴ほう症	記憶障害,物忘れ	記憶障害,健忘症
発音がおかしい	構音障害	構音障害
発音良く喋れない	呂律困難	構音障害
発音障害	失語症	失語症
白尿	蛋白尿	蛋白尿
白日夢	幻覚	幻覚
白目がぶよぶよする	粘膜浮腫	浮腫
白血球の死骸	痰	喀痰
白血病	髄外腫瘤,リンパ節腫脹	腫瘤,リンパ節腫大
皮下に腫瘤ができる	皮下腫瘤	皮下腫瘤
皮下の血管が破れて出血した状態	皮下出血	皮下出血
皮下出血	出血斑,皮下出血	斑状出血,皮下出血
皮下瘤	皮下腫瘤	皮下腫瘤
皮下紫斑	皮下出血斑	皮下出血
皮下組織にある血管が切れて出血すること	皮下出血	皮下出血
皮下組織血管出血	皮下出血	皮下出血
皮下腫	皮下腫瘤	皮下腫瘤
皮疹	発疹	発疹
皮膚	痂皮	痂皮
皮膚がはがれる	落屑	鱗屑
皮膚がん	皮下腫瘤	皮下腫瘤
皮膚がボロボロする	落屑	鱗屑
皮膚が乾いて細胞が死ぬ	乾酪壊死	壊死
皮膚が剥がれ落ちる	落屑	鱗屑
皮膚が紫になる	チアノーゼ	チアノーゼ
皮膚が紫色になる	チアノーゼ	チアノーゼ
皮膚が荒れる	皮膚黄染	黄疸
皮膚が赤い	発赤	発赤
皮膚が赤くなる	発赤	発赤
皮膚が赤くなること	発赤	発赤
皮膚が青紫色になる症状	チアノーゼ	チアノーゼ
皮膚が黄ばむ	皮膚黄染	黄疸
皮膚が黄色い	皮膚黄染	黄疸
皮膚が黄色くなる	皮膚黄染,黄疸	黄疸
皮膚が黄色く変化する病気	黄疸	黄疸
皮膚が黄色っぽい状態	黄疸	黄疸
皮膚が黄色っぽくなる	皮膚黄染	黄疸
皮膚が黄色なる	黄疸	黄疸
皮膚が黄色になる症状	黄疸	黄疸
皮膚と充血	発赤	発赤
皮膚にできた赤いできもの	紅色丘疹	紅色丘疹
皮膚にできもの	発疹	発疹
皮膚にできる発疹	皮疹	発疹
皮膚にできる発疹のこと	皮疹	発疹
皮膚にポツポツと出血のようなものがある	点状出血	点状出血
皮膚に出来物ができる	皮下腫瘤	皮下腫瘤
皮膚に出現する肉眼的変化である発疹	皮疹	発疹
皮膚のすぐ下が血が出て皮膚が斑のようになる	皮下出血斑	皮下出血
皮膚のただれ	皮疹	発疹
皮膚のほっしん	皮疹	発疹
皮膚の下から血が出る	皮下出血	皮下出血
皮膚の下での出血	皮下出血	皮下出血
皮膚の下にできたできもの	皮下腫瘤	皮下腫瘤
皮膚の下に固いしこりがある	皮下結節　	
皮膚の下に水が貯まる	浮腫	浮腫
皮膚の下のおでき	皮下腫瘤	皮下腫瘤
皮膚の下のしこった腫れ	皮下腫瘤	皮下腫瘤
皮膚の下のできもの	皮下腫瘤	皮下腫瘤
皮膚の下のグリグリ	皮下結節　	
皮膚の下のシコリ	皮下結節　	
皮膚の下の出血痕	皮下出血斑	皮下出血
皮膚の下の異常	皮下結節　	
皮膚の下の癌	皮下腫瘤	皮下腫瘤
皮膚の下関節	皮下結節　	
皮膚の中にふしがある	皮下結節　	
皮膚の中のしこり	皮下腫瘤	皮下腫瘤
皮膚の内出血	皮下出血斑	皮下出血
皮膚の変化	浮腫性変化	浮腫
皮膚の湿疹	皮疹	発疹
皮膚の炎症	発赤	発赤
皮膚の病気	痂皮	痂皮
皮膚の痒み	皮疹	発疹
皮膚の盛り上がり	丘疹	丘疹
皮膚の表層が大小の角質片となってはげ落ちること	落屑	鱗屑
皮膚の赤み	発赤,皮疹	発赤,発疹
皮膚の隆起	丘疹	丘疹
皮膚の黄ばみ	皮膚黄染	黄疸
皮膚や粘膜が青紫色である状態	チアノーゼ	チアノーゼ
皮膚内にこぶができる	皮下腫瘤	皮下腫瘤
皮膚内にできもの	皮下結節　	
皮膚内に点々とした出血	点状出血	点状出血
皮膚変色	黄疸	黄疸
皮膚炎	皮膚黄染,皮疹	黄疸,発疹
皮膚疾患	皮疹	発疹
皮膚病	腫瘍性病変,浮腫性変化	-1,浮腫
皮膚面から隆起する針頭大から米粒大ぐらいの局限性の発疹	丘疹	丘疹
盛り上がり	浮腫	浮腫
目がくらむ	眩暈	めまい
目がまわっているような感じがする	眩暈	めまい
目がまわる	めまい感,眩暈,めまい	めまい感,めまい
目が回った感じ	めまい感	めまい感
目が回っている	意識障害	意識障害
目が回る	めまい,めまい感,眩暈	めまい,めまい感
目が回るようなくらくらとした感覚	めまい	めまい
目が回る感じがすること	めまい感	めまい感
目が絡む	眩暈	めまい
目が見にくい	見当識障害	見当識障害
目が黄色い	黄疸	黄疸
目でみてわかる血尿	肉眼的血尿	肉眼的血尿
目でると尿に血が混ざっている	肉眼的血尿	肉眼的血尿
目で見て分かる尿に血が混ざった状態	肉眼的血尿	肉眼的血尿
目で見て分かる血尿	肉眼的血尿	肉眼的血尿
目で解る血の混じったおしっこ	肉眼的血尿	肉眼的血尿
目に見えて尿に血が混ざる	肉眼的血尿	肉眼的血尿
目に見えない血尿	顕微鏡的血尿	顕微鏡的血尿
目の前がくらくらする	眩暈	めまい
目の前が暗くなる	眼前暗黒感	眼前暗黒
目の前が暗く見える	眼前暗黒感	眼前暗黒
目の前が白いベールをかぶったように何も思い出せない	意識消失	意識消失
目の前が真っ暗	眼前暗黒感	眼前暗黒
目の前が真っ暗になる	眼前暗黒感,意識消失	眼前暗黒,意識消失
目の前真っ暗な感じ	眼前暗黒感	眼前暗黒
目や体が黄色い	黄疸	黄疸
目眩	ふらつき,意識障害	めまい,意識障害
盲目	眼前暗黒感	眼前暗黒
盲腸	左上腹部痛,急性腹症,下腹部痛,左下腹部痛,右下腹部痛,右側腹部痛	上腹部痛,急性腹症,下腹痛,下腹痛,臍下部痛,下腹痛,腸仙痛,側腹部痛
盲腸かな	右側腹部痛,右下腹部痛	側腹部痛,下腹痛,腸仙痛
直ぐに忘れてしまうこと	物忘れ	健忘症
真っすぐ歩けない	歩行困難,歩行障害	歩行困難,歩行障害
真っ赤なオシッコ	肉眼的血尿	肉眼的血尿
真っ青	チアノーゼ	チアノーゼ
真っ黒い軟便	タール便	黒色便
真っ黒な軟便	タール便	黒色便
眩暈	ふらつき,めまい感	めまい,めまい感
眼の前が暗くなる	眼前暗黒感	眼前暗黒
眼の前が真っ暗	眼前暗黒感	眼前暗黒
眼振	めまい感	めまい感
瞬痛症候群	激痛	疼痛
知らない	激痛,嘔気嘔吐	疼痛,嘔気,嘔吐症
知恵熱	不明熱	不明熱
知的障害	知覚障害	知覚障害
知能に問題がある	知覚障害	知覚障害
知覚の障害	知覚障害	知覚障害
知覚伝導路の障害やヒステリ－などの心因性の反応により刺激を正常に知覚できない状態	知覚障害	知覚障害
知覚機能不全	知覚障害	知覚障害
知覚異常	知覚障害,感覚異常,感覚障害	知覚障害,感覚異常症,体感異常
知覚過敏	温痛覚障害	温痛覚過敏
知覚障害	温痛覚障害,感覚異常	温痛覚過敏,感覚異常症
石工が混濁してる	意識障害	意識障害
砂糖高	高血糖	高血糖症
硬い	硬結,こわばり	硬結,こわばり
硬くなり動かなくなる	こわばり	こわばり
硬くなる	硬結,固縮,こわばり	硬結,こわばり
硬化	硬結,こわばり	硬結,こわばり
硬直	こわばり,固縮,硬結	こわばり,硬結
硬直痙攣	強直性痙攣	強直性痙攣
磨りガラスの様に見える	スリガラス影	胸部異常陰影
神経が鈍くなる	感覚鈍麻	感覚異常症
神経にさわる	しびれ感	しびれ感
神経失調	感覚鈍麻	感覚異常症
神経機能障害	失語	失語症
神経症	徐脈	徐脈
神経痛	しびれ,温痛覚障害,痺れ	しびれ感,温痛覚過敏
神経障害	不随意運動,感覚障害	不随意運動症,体感異常
神経障害性疼痛	癌性疼痛	癌性疼痛
穴が空いたようにうつること	空洞影	胸部異常陰影
空咳	乾性咳嗽,乾性咳	乾性咳
空咳が出る	乾性咳	乾性咳
空気のある影	空洞影	胸部異常陰影
空洞に見える	空洞影	胸部異常陰影
空洞のような影	空洞影	胸部異常陰影
突然おなかが痛くなる	腹痛発作	腹痛症
突然に死ぬ	突然死	突然死
突然のめまい	浮動性めまい	めまい
突然ぴくぴくする	痙攣発作	痙攣発作
突然亡くなる	突然死	突然死
突然体が意思に反してブルブルまたはピクピクと動く	痙攣発作	痙攣発作
突然体が震えだす	痙攣発作	痙攣発作
突然死亡する	突然死	突然死
突然気を失う	失神発作	失神
突然胸が痛くなる	胸痛発作	胸痛
突然胸の痛みに襲われる	胸痛発作	胸痛
突然腹痛に襲われる	急性腹症	急性腹症
突発的な熱	不明熱	不明熱
窒息	高二酸化炭素血症,呼吸困難,呼吸困難感,呼吸筋麻痺	高炭酸ガス血症,呼吸困難,呼吸麻痺
窒素	嚥下困難感	嚥下困難
立ちくらみ	眩暈,めまい,浮動性めまい,めまい感,眼前暗黒感,ふらつき	めまい,めまい感,眼前暗黒
立ち眩み	めまい,失神発作,眩暈	めまい,失神
筋力がおちる	四肢筋力低下	四肢筋力低下
筋力が弱くなる	筋力低下	筋力低下
筋力が落ちる	筋力低下,四肢筋力低下	筋力低下,四肢筋力低下
筋力が衰える	筋力低下	筋力低下
筋力で守る	筋性防御	筋性防御
筋力の衰え	筋力低下	筋力低下
筋力低下	四肢筋力低下,四肢脱力,筋力低下	四肢筋力低下,四肢脱力,筋力低下
筋力低下などの理由から安全に歩くことができないこと	歩行障害	歩行障害
筋弛緩	下肢脱力感	下肢脱力感
筋肉がこわばって震える	強直性痙攣	強直性痙攣
筋肉がつったままの痙攣	強直性痙攣	強直性痙攣
筋肉がない	筋力低下	筋力低下
筋肉がひきつる	痙攣,けいれん	痙攣
筋肉が弱ってる	四肢筋力低下	四肢筋力低下
筋肉が減る	筋力低下	筋力低下
筋肉が発作的に収縮する事	けいれん	痙攣
筋肉が緊張して硬くなる	こわばり	こわばり
筋肉が落ちた	筋力低下	筋力低下
筋肉が落ちる	筋力低下	筋力低下
筋肉で守る	筋性防御	筋性防御
筋肉で防御する 	筋性防御	筋性防御
筋肉のこわばり	固縮	こわばり
筋肉のひきつり	痙攣	痙攣
筋肉の収縮が長続きしこわばった状態	強直性痙攣	強直性痙攣
筋肉の強い強ばり	固縮	こわばり
筋肉の機能がおちる	筋力低下	筋力低下
筋肉の激しい収縮	けいれん	痙攣
筋肉の衰え	筋力低下	筋力低下
筋肉低下	筋力低下	筋力低下
筋肉内出血	皮下出血	皮下出血
筋肉弱化	筋力低下	筋力低下
筋肉痛	高乳酸血症,全身痛	高乳酸血症,全身痛
筋肉過多	けいれん発作	てんかん様発作,痙攣発作,痙攣重積発作,全身痙攣発作
筋肉量減少	筋力低下	筋力低下
筋量低下	筋力低下	筋力低下
筋防御	筋性防御	筋性防御
算数	ｍａｓｓ	腫瘤
節々が痛い	全身痛	全身痛
簡単に疲れてしまう	易疲労感	易疲労感
粒影	びまん性粒状影	胸部異常陰影
粒状にできた影	粒状陰影	胸部異常陰影
粒状のレントゲン写真	粒状陰影	胸部異常陰影
粒状の影	粒状陰影	胸部異常陰影
粒状影	粒状陰影	胸部異常陰影
粘膜が腫れている	粘膜浮腫	浮腫
粘膜が赤い	粘膜発赤	発赤
粘膜が赤くなる	粘膜発赤	発赤
粘膜が赤くなること	粘膜発赤	発赤
粘膜が赤くはれる	粘膜発赤	発赤
粘膜に腫れやむくみ	粘膜浮腫	浮腫
粘膜のむくみ	粘膜浮腫	浮腫
粘膜の損傷	粘膜発赤	発赤
粘膜の癌	粘膜浮腫	浮腫
粘膜の腫れ	粘膜浮腫	浮腫
粘膜湿疹	粘膜発赤	発赤
精神障害	記憶障害	記憶障害
糖が高い	高血糖	高血糖症
糖に耐える機能の異常	耐糖能異常	耐糖能異常
糖に耐える機能の障害	耐糖能障害	耐糖能異常
糖に耐える能力の異常	耐糖能異常	耐糖能異常
糖の摂り過ぎ	耐糖能障害	耐糖能異常
糖を代謝する機能の異常	耐糖能異常	耐糖能異常
糖分とりすぎ	高血糖	高血糖症
糖分をうまく消化できん	耐糖能障害	耐糖能異常
糖尿	高血糖,耐糖能異常,尿蛋白,高度蛋白尿,蛋白尿	高血糖症,耐糖能異常,蛋白尿
糖尿かな	耐糖能異常,食後高血糖	耐糖能異常,高血糖症
糖尿病	耐糖能障害,境界型糖尿病,食後高血糖,高血糖,尿蛋白,耐糖能異常,蛋白尿	耐糖能異常,境界型糖尿病,高血糖症,蛋白尿
糖尿病になりかけ	境界型糖尿病	境界型糖尿病
糖尿病の境目	境界型糖尿病	境界型糖尿病
糖尿病ギリギリ	境界型糖尿病	境界型糖尿病
糖尿病一歩手前	耐糖能障害	耐糖能異常
糖尿病予備軍	境界型糖尿病,耐糖能異常	境界型糖尿病,耐糖能異常
糖尿病前段階	高血糖	高血糖症
糸球体腎炎	低補体血症	低補体血症
紅斑	粘膜発赤,点状出血,発赤	発赤,点状出血
素晴らしいくらっくる	ｆｉｎｅ　ｃｒａｃｋｌｅｓ	湿性ラ音
索状に見える陰影	線状影	胸部異常陰影
紫外線過多	皮下腫瘤	皮下腫瘤
紫斑	出血斑,皮下出血斑	斑状出血,皮下出血
紫色っぽい肌色	チアノーゼ	チアノーゼ
紫色になる	チアノーゼ	チアノーゼ
紫藍症	チアノーゼ	チアノーゼ
細かく震える	痙攣	痙攣
細胞が分かれてる	蛋白細胞解離	髄液蛋白細胞数解離
細胞が壊れること	壊死	壊死
細胞が死ぬ	壊死	壊死
細胞が死滅	壊死	壊死
細胞が腐ること	壊死	壊死
細胞のたまった腫瘤	充実性腫瘤	腫瘤
細胞組織が死ぬ	壊死	壊死
組織が充血やうっ血で硬くなる	硬結	硬結
組織が壊れる	壊死	壊死
組織が死ぬ	壊死	壊死
組織の局所的死	壊死	壊死
組織破壊	壊死	壊死
経口摂取障害	経口摂取困難	経口摂取困難
結核	乾酪壊死,両側肺門部リンパ節腫脹,喀血	壊死,肺門リンパ節腫脹,喀血
結核かな	胸部異常影	胸部異常陰影
結核かも	肺浸潤影	肺部異常陰影
結節影	粒状陰影,スリガラス陰影,肺結節影	胸部異常陰影,肺部異常陰影
結節陰影	肺結節影	肺部異常陰影
絞扼感	安静時胸痛	反復性胸痛,胸痛
絶望	全身リンパ節腫脹,多臓器障害,全身性浮腫	リンパ節腫大,多臓器不全,全身性浮腫
網状影	スリガラス影	胸部異常陰影
緊張	こわばり	こわばり
緊張呼吸難	労作時呼吸困難感	労作時呼吸困難
緊張感	口渇	口渇症
緊急事態	頻拍	頻拍症
緊急疾患	出血性ショック	出血性ショック
緑内障	眼前暗黒感	眼前暗黒
線になった影	線状影	胸部異常陰影
線の様に見えるレントゲン写真	線状影	胸部異常陰影
線状の影	線状影	胸部異常陰影
線状陰影	線状影	胸部異常陰影
線維筋痛症	全身痛	全身痛
締め付けられる	圧痛	圧痛
締め付けられるような息苦しさ	胸部絞扼感	胸部不快感
縛られた感じ	圧痛	圧痛
縦方向にはしるリンパの腫れ	縦隔リンパ節腫脹	縦隔リンパ節腫脹
縦隔にあるリンパ節が腫れる	縦隔リンパ節腫大	縦隔リンパ節腫脹
縦隔にブツブツとしたものがある	縦隔リンパ節腫脹	縦隔リンパ節腫脹
縦隔のリンパにできもの	縦隔リンパ節腫大	縦隔リンパ節腫脹
縦隔リンパ節が腫れている	縦隔リンパ節腫大	縦隔リンパ節腫脹
縦隔リンパ節が腫れて体積を増している状態	縦隔リンパ節腫大	縦隔リンパ節腫脹
縦隔リンパ節腫れ	縦隔リンパ節腫脹	縦隔リンパ節腫脹
縦隔リンパ節腫大	縦隔リンパ節腫大	縦隔リンパ節腫脹
縦隔リンパ節腫脹	縦隔リンパ節腫大	縦隔リンパ節腫脹
繊維筋痛症	全身痛	全身痛
老化	筋力低下,物忘れ	筋力低下,健忘症
耐えられない痛み	激痛	疼痛
耐糖能異常	耐糖能異常	耐糖能異常
耐糖能障害	境界型糖尿病	境界型糖尿病
耳がおかしい	耳下腺腫脹	耳下腺腫脹
耳の下が腫れる	耳下腺腫脹	耳下腺腫脹
耳の下にできる腫瘍	耳下腺腫脹	耳下腺腫脹
耳の下のはれ	耳下腺腫脹	耳下腺腫脹
耳の下の腺がはれる	耳下腺腫脹	耳下腺腫脹
耳の不調	構音障害	構音障害
耳の後ろのリンパが腫れる	頚部リンパ節腫脹	頚部リンパ節腫脹
耳の腫れ	耳下腺腫脹	耳下腺腫脹
耳下腺炎	耳下腺腫脹	耳下腺腫脹
耳下腺腫れ	耳下腺腫脹	耳下腺腫脹
耳痛	耳下腺腫脹	耳下腺腫脹
耳石障害	失調性歩行	失調性歩行
聞き取ることはできる（相手がしゃべっている内容は理解できている）がしゃべれない状態	運動性失語	運動性失語症
聴きずらい	構音障害	構音障害
聴診器で聞くと雑音が入っとる	心雑音	心雑音
肉体的に苦しい	痛み	疼痛
肉眼ではわからない血尿	顕微鏡的血尿	顕微鏡的血尿
肉眼では見えない微量の出血	潜血	顕微鏡的血尿
肉眼で血尿が確認できる	肉眼的血尿	肉眼的血尿
肉眼的血尿	肉眼的血尿	肉眼的血尿
肋膜炎	胸膜炎	胸膜炎
肋間神経痛	左季肋部痛,左側胸部痛	季肋部痛,側胸部痛
肋関神経痛	右季肋部痛	季肋部痛
肋骨の左側が痛い状態	左季肋部痛	季肋部痛
肋骨弓部の下の痛みを	左季肋部痛	季肋部痛
肋骨痛, 体動時の限局した痛み	軽度圧痛	圧痛
肌がかゆい	皮疹,痂皮	発疹,痂皮
肌が黄色い	黄染,黄疸	黄疸
肌が黄色くなる	黄疸	黄疸
肌が黄色みをおびる	黄疸	黄疸
肌に出来物が出る	発疹	発疹
肌のアレ	皮疹	発疹
肝不全	右胸部痛,肝機能異常	側胸部痛,肝機能検査異常
肝容積の異常な増大	肝腫大	肝腫大
肝機能がおかしい	肝機能異常	肝機能検査異常
肝機能不全	肝機能異常	肝機能検査異常
肝機能低下	肝機能異常	肝機能検査異常
肝機能異常	肝機能異常	肝機能検査異常
肝機能障害	肝機能異常,肝脾腫	肝機能検査異常,肝脾腫
肝炎	肝脾腫,肝機能異常	肝脾腫,肝機能検査異常
肝硬変	肝機能異常,肝脾腫,腹水貯留	肝機能検査異常,肝脾腫,腹水症
肝脾腫	肝脾腫	肝脾腫
肝脾腫れ	肝脾腫	肝脾腫
肝腫大	肝腫大	肝腫大
肝臓がはれる	肝脾腫	肝脾腫
肝臓がん	肝脾腫	肝脾腫
肝臓が大きくなる	肝腫大	肝腫大
肝臓が悪い	肝機能異常	肝機能検査異常
肝臓が悪くなる	肝機能異常	肝機能検査異常
肝臓が機能障害を起こす	肝機能異常	肝機能検査異常
肝臓が異常	肝機能異常	肝機能検査異常
肝臓が病的に大きくなること	肝腫大	肝腫大
肝臓が腫れている	肝脾腫,肝腫大	肝脾腫,肝腫大
肝臓が腫れて大きくなっている	肝腫大	肝腫大
肝臓が腫れて大きくなってる	肝腫大	肝腫大
肝臓が腫れる	肝脾腫,肝腫大	肝脾腫,肝腫大
肝臓と脾臓が拡大	肝脾腫	肝脾腫
肝臓と脾臓の腫れ	肝脾腫	肝脾腫
肝臓にできもの	肝脾腫	肝脾腫
肝臓に腫瘍がある	肝脾腫	肝脾腫
肝臓のできもの	肝腫大	肝腫大
肝臓の不正常	肝機能異常	肝機能検査異常
肝臓の働きの低下	肝機能異常	肝機能検査異常
肝臓の数値がおかしい	肝機能異常	肝機能検査異常
肝臓の数値が基準値を上回るまたは下回る	肝機能異常	肝機能検査異常
肝臓の数値が悪い	肝機能異常	肝機能検査異常
肝臓の数値が高い	肝機能異常	肝機能検査異常
肝臓の数値異常	肝機能異常	肝機能検査異常
肝臓の機能がおかしい	肝機能異常	肝機能検査異常
肝臓の腫れ	肝腫大	肝腫大
肝臓の腫れ物	肝脾腫	肝脾腫
肝臓の腫瘍	肝脾腫	肝脾腫
肝臓ガン	肝脾腫	肝脾腫
肝臓及び肝臓の働きが悪くなる	肝機能異常	肝機能検査異常
肝臓疾患	肝腫大	肝腫大
肝臓病	黄疸	黄疸
肝臓肥大	肝腫大	肝腫大
肝臓脾臓のがん	肝脾腫	肝脾腫
肝臓脾臓の腫瘍	肝脾腫	肝脾腫
肝障害	肝機能異常	肝機能検査異常
股の付近で血が出ている	性器出血	性器出血
股んとこめっちゃ腫れとる	リンパ節腫大	リンパ節腫大
肥える	体重増加	体重増加
肥大	腫大,膵腫大	リンパ節腫大,膵腫大
肥満	腹部膨隆,体重増加,耐糖能障害,高ＩｇＥ血症,高乳酸血症,膨満,高LDH血症,腹部膨満	腹部膨満,体重増加,耐糖能異常,高ＩｇＥ血症,高乳酸血症
肥満化	体重増加	体重増加
肩が上がらない	落屑	鱗屑
肩が痛い	落屑	鱗屑
肩が落ちる	落屑	鱗屑
肩に子供を一人乗せたような体がぎこちない	体重増加	体重増加
肩外れる	落屑	鱗屑
肺あたりに異常	肺浸潤影	肺部異常陰影
肺うっ血	肺うっ血像	胸部異常陰影
肺うっ血症	肺うっ血像	胸部異常陰影
肺からの出血	びまん性肺胞出血,肺出血	肺胞出血,肺出血
肺から出血する	肺出血	肺出血
肺から吐血	肺胞出血	肺胞出血
肺から血が出る	肺出血	肺出血
肺がうっ血してる状態	肺うっ血像	胸部異常陰影
肺がおかしい	肺腫瘤	肺腫瘤
肺がん	肺腫瘤,両側肺門部リンパ節腫脹,胸部異常影,肺結節影	肺腫瘤,肺門リンパ節腫脹,胸部異常陰影,肺部異常陰影
肺が出血してる	肺胞出血	肺胞出血
肺が拘束され広がらない障害	拘束性換気障害	拘束性換気障害
肺が苦しい	拘束性換気障害	拘束性換気障害
肺にできたコブ	肺腫瘤	肺腫瘤
肺に出血	びまん性肺胞出血	肺胞出血
肺に出血がある	肺出血	肺出血
肺に影	肺陰影	胸部異常陰影
肺に影がある	胸部異常陰影,肺陰影,肺結節影,胸部異常影	胸部異常陰影,肺部異常陰影
肺に影がある状態	肺うっ血像	胸部異常陰影
肺に影が出た	スリガラス状陰影	胸部異常陰影
肺に影が出る	胸部陰影,肺うっ血像,肺陰影	胸部異常陰影
肺に影が見られる症状	肺陰影	胸部異常陰影
肺に影が見受けられる	肺陰影	胸部異常陰影
肺に水がたまる	膵性胸水,肺浸潤影	胸水検査異常,肺部異常陰影
肺に水が溜まっている	肺浸潤影	肺部異常陰影
肺に水が溜まる	胸腹水	腹水症
肺に異常がみられること	肺野病変	肺野異常陰影
肺に血液が滞留した状態	肺うっ血像	胸部異常陰影
肺のいぼ	肺結節影	肺部異常陰影
肺のデキモノ	肺腫瘤	肺腫瘤
肺のリンパが腫れる	両側肺門リンパ節腫脹	両側肺門リンパ節腫脹
肺のリンパの腫れ	両側肺門リンパ節腫脹	両側肺門リンパ節腫脹
肺のレントゲンで粒々の影が複数映る	粒状陰影	胸部異常陰影
肺のレントゲンの影	スリガラス状陰影,肺浸潤影,スリガラス影	胸部異常陰影,肺部異常陰影
肺のレントゲン写真	肺浸潤影,肺陰影	肺部異常陰影,胸部異常陰影
肺のレントゲン映像の影	肺浸潤影	肺部異常陰影
肺の一部に出血	びまん性肺胞出血	肺胞出血
肺の中がへん	肺野病変	肺野異常陰影
肺の中で出血	肺胞出血	肺胞出血
肺の中にできものができる	肺腫瘤	肺腫瘤
肺の中に血が溜まっている	肺出血	肺出血
肺の中に辺縁がはっきりしない異常な影（おもにガン）がある状態	肺浸潤影	肺部異常陰影
肺の中の出血	肺出血,嚢胞内出血	肺出血,内出血
肺の入り口にあるできものが大きくなっている	肺門リンパ節腫大	肺門リンパ節腫脹
肺の入り口のできもの	肺門リンパ節腫大	肺門リンパ節腫脹
肺の出来物	肺腫瘤	肺腫瘤
肺の出血	肺出血,肺胞出血	肺出血,肺胞出血
肺の影	肺陰影,胸部陰影,胸部異常影,肺門リンパ節腫大,肺結節影	胸部異常陰影,肺門リンパ節腫脹,肺部異常陰影
肺の液が漏れとる	嚢胞性腫瘤	腫瘤
肺の異常	びまん性肺胞出血	肺胞出血
肺の病気	肺野病変,肺腫瘤	肺野異常陰影,肺腫瘤
肺の病気の状態が変わる	肺野病変	肺野異常陰影
肺の腫瘍	肺腫瘤	肺腫瘤
肺の膜が炎症	胸膜炎	胸膜炎
肺の血	肺うっ血像	胸部異常陰影
肺の血流が悪くなっている症状がレントゲンに写っている症状	肺うっ血像	胸部異常陰影
肺の表面の炎症	胸膜炎	胸膜炎
肺の辺りが苦しい	肺野病変	肺野異常陰影
肺の辺りに見られる異常	肺野病変	肺野異常陰影
肺の部分の病気部分	肺野病変	肺野異常陰影
肺の間のリンパ腺の腫れ	縦隔リンパ節腫脹	縦隔リンパ節腫脹
肺の陰	肺陰影	胸部異常陰影
肺の雑音	湿性ラ音	湿性ラ音
肺や腹部に水が貯まる	胸腹水	腹水症
肺ガン	肺腫瘤	肺腫瘤
肺レントゲン	肺陰影	胸部異常陰影
肺レントゲンの線状の影	線状影	胸部異常陰影
肺全体からの出血	びまん性肺胞出血	肺胞出血
肺内出血	肺出血	肺出血
肺内血管内の血液量が増加している状態	肺うっ血像	胸部異常陰影
肺出血	肺胞出血,びまん性肺胞出血,嚢胞内出血	肺胞出血,内出血
肺実質病変	気管支透亮像	胸部異常陰影
肺影	胸部異常影	胸部異常陰影
肺打撲	肺出血	肺出血
肺末梢小型病変	スリガラス様陰影	胸部異常陰影
肺気腫	胸部異常陰影,閉塞性換気障害,スリガラス状陰影,肺浸潤影,胸腹水	胸部異常陰影,閉塞性換気障害,肺部異常陰影,腹水症
肺水腫	肺うっ血像	胸部異常陰影
肺濁音	喘鳴	喘鳴
肺炎	肺結節影,心陰影,肺陰影,胸膜炎,胸部異常陰影	肺部異常陰影,胸部異常陰影,胸膜炎
肺炎の症状	肺出血	肺出血
肺異常影	肺陰影	胸部異常陰影
肺疾患	胸膜炎,肺野病変,胸苦	胸膜炎,肺野異常陰影,胸部不快感
肺病	肺出血	肺出血
肺癌	肺腫瘤	肺腫瘤
肺紋理	胸部異常陰影	胸部異常陰影
肺結核	肺結節影,粒状陰影	肺部異常陰影,胸部異常陰影
肺胞からの出血	肺胞出血	肺胞出血
肺胞から血が出る	肺胞出血	肺胞出血
肺胞で出血	肺胞出血	肺胞出血
肺胞に血が出てる	肺胞出血	肺胞出血
肺胞出血	肺胞出血	肺胞出血
肺胞腔内に血液が充満する病態	肺胞出血	肺胞出血
肺胞蛋白症	スリガラス影	胸部異常陰影
肺腫瘍	肺腫瘤,胸部異常陰影	肺腫瘤,胸部異常陰影
肺腺腫	右胸痛	胸痛
肺部X線の影	胸部陰影	胸部異常陰影
肺部の影	スリガラス影,スリガラス陰影,胸部異常影	胸部異常陰影
肺部の疾患	肺胞出血,労作時息切れ	肺胞出血,息切れ
肺部障害	労作時呼吸苦	労作時呼吸困難
肺門のリンパ節が腫れて大きくなっている	肺門リンパ節腫大	肺門リンパ節腫脹
肺門リンパ節腫脹	肺門リンパ節腫大	肺門リンパ節腫脹
肺雑音	湿性ラ音	湿性ラ音
胃がいたい	上腹部痛	上腹部痛
胃がおかしい	胃部不快感	腹部不快感
胃がまぐまぐする	胃部不快感	腹部不快感
胃がむかむかする	胃部不快感	腹部不快感
胃がもたれる	胃部不快感	腹部不快感
胃がムカムカする	胃部不快感	腹部不快感
胃が不快	胃部不快感	腹部不快感
胃が気持ち悪い	胃部不快感	腹部不快感
胃が気持ち悪いこと	上腹部不快感	腹部不快感
胃が痛い	上腹部痛	上腹部痛
胃が重い	胃部不快感	腹部不快感
胃に不快感	胃部不快感	腹部不快感
胃のあたりが痛い	上腹部痛	上腹部痛
胃のあたりの痛み	上腹部不快感	腹部不快感
胃のあたりを不快に感じる	胃部不快感	腹部不快感
胃のむかつき	胃部不快感,上腹部不快感	腹部不快感
胃のもたれ	腹部膨隆,腹部違和感,胃部不快感	腹部膨満,腹部不快感
胃の不快感	上腹部不快感	腹部不快感
胃の不調	胃部不快感	腹部不快感
胃の中のものをもどす	嘔吐	嘔吐症
胃の中のものを吐いてもどすこと	嘔吐	嘔吐症
胃の中の消化物を吐くこと	嘔吐	嘔吐症
胃の痛み	腹部痛	腹痛症
胃の調子が悪い	食欲不振	食欲不振
胃の辺りが痛い	右上腹部痛	上腹部痛
胃の違和感	胃部不快感	腹部不快感
胃もたれ	胃部不快感,上腹部不快感,腹部膨満感,腹部膨満	腹部不快感,腹部膨満
胃や十二指腸から出血して出る便	黒色便	黒色便
胃カメラ	気管支透亮像	胸部異常陰影
胃壁の部分壊死	門脈ガス血症	門脈ガス血症
胃痛	胃部不快感,上腹部痛,左上腹部痛,腹痛	腹部不快感,上腹部痛,腹痛症,腹壁痛,仙痛
胃腸のあたりに不快感がある	胃部不快感	腹部不快感
胃膨張	膨満	腹部膨満
胃膨満	胃部不快感	腹部不快感
胃部の不快な感じ	胃部不快感	腹部不快感
胃部不快感	上腹部不快感	腹部不快感
胆嚢炎	右側腹部痛	側腹部痛
胆嚢疾患	黄疸	黄疸
胆嚢障害	黄疸	黄疸
胆石	右季肋部痛	季肋部痛
胎児性抗原高値	ＣＥＡ高値	ＣＥＡ高値
胴に水がたまる	胸腹水	腹水症
胴体のリンパが腫れる	縦隔リンパ節腫脹	縦隔リンパ節腫脹
胸いた	胸痛,胸部痛,左前胸部痛	胸痛,前胸部痛
胸からの出血	肺出血	肺出血
胸が	胸部痛	胸痛
胸があぶる	動悸	動悸
胸がいたい	胸痛	胸痛
胸がいたか	胸部痛	胸痛
胸がおかしい	胸部違和感	胸部不快感
胸がきつい	胸部圧迫感	胸内苦悶
胸がくるしい	胸苦	胸部不快感
胸がしめつけられる	胸部圧迫感	胸内苦悶
胸がつかえる	前胸部圧迫感	胸部不快感
胸がつまる、、	息切れ	息切れ
胸がどきどきする	動悸	動悸
胸がどくどくする	動悸発作	動悸
胸がなんかおかしい	胸部違和感	胸部不快感
胸がへん	胸部違和感	胸部不快感
胸がむかむかし吐きたい気持ちまたは吐く行為	嘔気嘔吐	嘔気,嘔吐症
胸がむかむかする	胸部不快感	胸部不快感
胸がもやもやする	胸部不快感	胸部不快感
胸がやむ	心窩部不快感	心窩部不快
胸がザワザワする	胸部違和感	胸部不快感
胸がズキズキする	右前胸部痛,胸痛	前胸部痛,胸痛
胸がドキドキ	動悸	動悸
胸がドキドキする	動悸,動悸発作	動悸
胸がドキドキバクバク	動悸	動悸
胸がバクバクする	動悸発作,動悸	動悸
胸が不快	胸部不快感	胸部不快感
胸が切ない	労作時胸痛,胸痛発作	反復性胸痛,胸痛,胸痛
胸が圧迫される	胸部圧迫感,圧痛	胸内苦悶,圧痛
胸が圧迫される感じ	前胸部圧迫感	胸部不快感
胸が急に痛くなる	胸痛発作	胸痛
胸が急に痛む	胸痛発作	胸痛
胸が悪い	悪心	悪心
胸が押さえつけられる	胸部圧迫感	胸内苦悶
胸が押さえつけられるような感じ	胸部圧迫感	胸内苦悶
胸が押されるような	胸部圧迫感	胸内苦悶
胸が押されるような感じ	前胸部圧迫感	胸部不快感
胸が押される感じ	胸部圧迫感	胸内苦悶
胸が押しつけられる	圧痛	圧痛
胸が正常ではない感じ	胸部不快感	胸部不快感
胸が気持ちが悪い	胸部不快感	胸部不快感
胸が気持ち悪い	胸部違和感,胸部不快感	胸部不快感
胸が潰れる感じ	胸部絞扼感	胸部不快感
胸が痛い	胸痛,胸部痛,全胸部痛,胸痛発作,左前胸部痛,左側胸部痛,右前胸部痛,胸部圧迫感,右胸痛,胸苦,左胸痛,右側胸部痛,左胸部痛,労作時胸痛,右胸部痛,前胸部圧迫感,左季肋部痛,胸部違和感	胸痛,前胸部痛,側胸部痛,胸内苦悶,胸部不快感,反復性胸痛,胸痛,季肋部痛
胸が痛いこと	胸痛	胸痛
胸が痛い発作	胸痛発作	胸痛
胸が痛くなる	胸痛発作	胸痛
胸が痛くなる発作	胸痛発作	胸痛
胸が痛む	胸部痛,胸痛,胸痛発作	胸痛
胸が突然痛む	胸痛発作	胸痛
胸が締め付けられているような感じ	胸部絞扼感	胸部不快感
胸が締め付けられる	胸部圧迫感,胸部絞扼感,胸痛	胸内苦悶,胸部不快感,胸痛
胸が締め付けられるようだ	胸部圧迫感	胸内苦悶
胸が締め付けられるような感覚	胸部絞扼感	胸部不快感
胸が締め付けられるように痛い	胸部絞扼感	胸部不快感
胸が締め付けられる感じ	胸部絞扼感	胸部不快感
胸が締め付けられる感じがする	前胸部圧迫感	胸部不快感
胸が苦しい	胸部圧迫感,胸苦,胸部不快感,胸部絞扼感,胸部違和感,前胸部圧迫感,両側肺門リンパ節腫脹,動悸,安静時胸痛,呼吸苦,胸痛発作,胸痛,左側胸部痛,左前胸部痛,呼吸困難感,胸部痛,動悸発作	胸内苦悶,胸部不快感,両側肺門リンパ節腫脹,動悸,反復性胸痛,胸痛,呼吸促迫,呼吸困難,胸痛,側胸部痛,前胸部痛,呼吸麻痺
胸が苦しい感じ	胸苦,胸部違和感	胸部不快感
胸が苦しくなる	胸苦	胸部不快感
胸が詰まる	拘束性換気障害	拘束性換気障害
胸が重い	胸痛,胸部圧迫感,全胸部痛,右側胸部痛,胸部痛,胸部違和感	胸痛,胸内苦悶,胸部不快感
胸とお腹に水がたまる	胸腹水	腹水症
胸と腹に水がたまる	胸腹水	腹水症
胸にある違和感	胸部違和感	胸部不快感
胸にいつもと違った感じがすること	胸部違和感	胸部不快感
胸につかえがある	胸部圧迫感	胸内苦悶
胸にモヤモヤ感がある	胸部違和感	胸部不快感
胸に不快感がある	胸部不快感	胸部不快感
胸に何かしら影が見える	胸部異常陰影	胸部異常陰影
胸に変な影がある	胸部異常陰影	胸部異常陰影
胸に変な感じがする	胸部違和感	胸部不快感
胸に嫌な感じがある	胸部不快感	胸部不快感
胸に影	胸部陰影,胸部異常影,胸部異常陰影	胸部異常陰影
胸に影がある	胸部異常陰影,胸部陰影,胸部異常影	胸部異常陰影
胸に影が映る	胸部異常陰影	胸部異常陰影
胸に影が見られる症状	胸部陰影	胸部異常陰影
胸に怪しい影が映る	胸部異常影	胸部異常陰影
胸に水がたまる	胸腹水	腹水症
胸に水が溜まってる	胸腹水	腹水症
胸に水が溜まる	胸腹水	腹水症
胸に水が貯まる	胸腹水	腹水症
胸に水貯まる	胸腹水	腹水症
胸に異常な影あり	胸部異常影	胸部異常陰影
胸に異常な影がある	胸部異常影	胸部異常陰影
胸に異常を感じる	胸部違和感	胸部不快感
胸に異常を示す画像検査結果	胸部異常影	胸部異常陰影
胸に痛い	胸痛	胸痛
胸に痛みを感じる	胸部痛	胸痛
胸に違和感	胸部違和感	胸部不快感
胸に違和感がある	胸部不快感,胸部違和感	胸部不快感
胸のあたりがもぞもぞする	胸部不快感	胸部不快感
胸のあたりが痛い	胸痛	胸痛
胸のあたりが痛むこと	胸部痛	胸痛
胸のあたりが重い	胸腹水	腹水症
胸のあたりに違和感がある	胸部違和感	胸部不快感
胸のあたりの痛み	胸部痛	胸痛
胸のあたりの違和感	胸部不快感	胸部不快感
胸のつかえ	胸部絞扼感	胸部不快感
胸のところが痛い	胸部痛	胸痛
胸のむかつき	胸部不快感,上腹部不快感	胸部不快感,腹部不快感
胸のムカつき	胸部不快感	胸部不快感
胸のムカツキによって胃の中の物が出そうになること	吐き気	嘔気
胸のレントゲンに影がある	スリガラス影	胸部異常陰影
胸のレントゲンに異常あり	胸部異常陰影	胸部異常陰影
胸のレントゲンの正常でない影	胸部異常陰影	胸部異常陰影
胸のレントゲンの異常な陰影	胸部異常影	胸部異常陰影
胸のレントゲン上すりガラスのようになっている	スリガラス陰影	胸部異常陰影
胸のレントゲン上に影がある	胸部異常影	胸部異常陰影
胸のレントゲン写真映像の異常	胸部異常陰影	胸部異常陰影
胸の上の方（おっぱいより上）が押しつぶされるような感じ	前胸部圧迫感	胸部不快感
胸の不快感	胸部不快感	胸部不快感
胸の内部水	胸腹水	腹水症
胸の写真に影が写った	胸部異常陰影	胸部異常陰影
胸の前あたりの痛み	全胸部痛	
胸の前が押されている感じがする	前胸部圧迫感	胸部不快感
胸の前の方が痛い	全胸部痛	
胸の前の方圧迫される	前胸部圧迫感	胸部不快感
胸の前の部分が痛い	全胸部痛	
胸の前側が痛い	全胸部痛	
胸の前側に押されるような感じがある	前胸部圧迫感	胸部不快感
胸の前部が痛い	全胸部痛	
胸の右が痛い	右胸部痛	側胸部痛
胸の右側の痛み	右胸部痛	側胸部痛
胸の圧迫感	前胸部圧迫感,胸部圧迫感	胸部不快感,胸内苦悶
胸の変な影	胸部異常影	胸部異常陰影
胸の変な感じ	胸部違和感	胸部不快感
胸の左上が痛い	左前胸部痛	前胸部痛
胸の左側が痛い	左側胸部痛	側胸部痛
胸の左側が痛むこと	左胸部痛	胸痛
胸の影	胸部陰影,胸部異常陰影,胸部異常影	胸部異常陰影
胸の水	膵性胸水	胸水検査異常
胸の炎症	胸膜炎	胸膜炎
胸の状態がおかしいと感じる	胸部違和感	胸部不快感
胸の画像に影がある	胸部異常陰影,胸部異常影	胸部異常陰影
胸の異常	胸部絞扼感	胸部不快感
胸の異常を感じる	胸部不快感	胸部不快感
胸の痛み	全胸部痛,胸痛発作,胸痛,胸部痛,左前胸部痛,右側胸部痛,胸苦	胸痛,前胸部痛,胸部不快感
胸の痛みの発作	胸痛発作	胸痛
胸の痛みを伴う発作	胸痛発作	胸痛
胸の粘膜が炎症を起こす	胸膜炎	胸膜炎
胸の苦しみ	胸苦	胸部不快感
胸の辺りが痛い	安静時胸痛,左胸痛,全胸部痛,左季肋部痛,胸部痛	反復性胸痛,胸痛,胸痛,季肋部痛
胸の辺りが痛いこと	胸部痛	胸痛
胸の辺りが苦しい	胸膜炎,胸部不快感	胸膜炎,胸部不快感
胸の違和感	胸部違和感,胸部不快感	胸部不快感
胸の雑音	心雑音	心雑音
胸の鼓動が速くなる	動悸	動悸
胸のＸ線写真で、肺野内の白くザラザラとした均一な影	スリガラス状陰影	胸部異常陰影
胸やお腹に水が貯まる	胸腹水	腹水症
胸やけ	胸部不快感,胸部圧迫感,腹部違和感,心窩部不快感,膨満,上腹部不快感	胸部不快感,胸内苦悶,腹部不快感,心窩部不快,腹部膨満
胸や心臓が苦しい	胸部圧迫感	胸内苦悶
胸や心臓のあたりが嫌な感じがする	胸部不快感	胸部不快感
胸を押される感じがする	前胸部圧迫感	胸部不快感
胸を押される様なかんじ	胸部圧迫感	胸内苦悶
胸を締め付けられるような感じ	胸部絞扼感	胸部不快感
胸を締め付ける感覚	胸部絞扼感	胸部不快感
胸レントゲン写真	胸部陰影	胸部異常陰影
胸付近の横隔膜の炎症	胸膜炎	胸膜炎
胸元の痛み	全胸部痛	
胸内苦悶	胸苦	胸部不快感
胸水貯留	肺野病変	肺野異常陰影
胸焼け	胸部不快感,上腹部不快感,胸部違和感,腹部膨満感,胃部不快感	胸部不快感,腹部不快感,腹部膨満
胸痛	前胸部圧迫感,左胸部痛,胸苦,全胸部痛,胸部痛,左前胸部痛,右胸部痛,心窩部痛,右側胸部痛,圧痛,動悸,左胸痛,右胸痛,右前胸部痛,胸痛発作,左側胸部痛	胸部不快感,胸痛,前胸部痛,側胸部痛,心窩部痛,圧痛,動悸
胸痛い	左前胸部痛	前胸部痛
胸腹水	胸腹水	腹水症
胸腹部に水がたまる	胸腹水	腹水症
胸腹部に水が溜まる	胸腹水	腹水症
胸腹部に炎症	胸膜炎	胸膜炎
胸腺疾患	縦隔リンパ節腫脹	縦隔リンパ節腫脹
胸膜の炎症	胸膜炎	胸膜炎
胸膜炎	胸膜炎	胸膜炎
胸膜炎症	胸膜炎	胸膜炎
胸苦しい	胸部不快感,胸苦,胸部圧迫感	胸部不快感,胸内苦悶
胸苦しさ	胸部圧迫感	胸内苦悶
胸部 X 線写真に見られる影	心陰影	胸部異常陰影
胸部X線	心陰影拡大,胸部異常陰影	胸部異常陰影
胸部X線の影	肺陰影	胸部異常陰影
胸部X線影	胸部異常影	胸部異常陰影
胸部X線検査によって得られた肺うっ血の像	肺うっ血像	胸部異常陰影
胸部が押されるような痛み	胸部圧迫感	胸内苦悶
胸部に不快感	胸部違和感	胸部不快感
胸部に影	胸部陰影	胸部異常陰影
胸部に影がある	胸部異常陰影,胸部異常影	胸部異常陰影
胸部に影が見える	胸部異常陰影	胸部異常陰影
胸部に違和感がある	胸部不快感	胸部不快感
胸部のいたみ	全胸部痛	
胸部のレントゲンに影	胸部異常陰影	胸部異常陰影
胸部の不快感	上腹部不快感	腹部不快感
胸部の影	胸部陰影	胸部異常陰影
胸部の痛み	胸部痛	胸痛
胸部エックス線写真では肺は黒っぽく見えること	胸部陰影	胸部異常陰影
胸部エックス線写真上上肺に空洞や気管支に沿った小粒状影	粒状陰影	胸部異常陰影
胸部レントゲン	胸部陰影	胸部異常陰影
胸部レントゲンで影が映る	胸部異常影,胸部異常陰影	胸部異常陰影
胸部レントゲンに影がある	胸部異常影	胸部異常陰影
胸部レントゲンの異常な影	胸部異常影	胸部異常陰影
胸部レントゲン異常あり	胸部異常陰影	胸部異常陰影
胸部不快感	胸部不快感,心窩部不快感,胸部違和感	胸部不快感,心窩部不快
胸部圧痛	胸部圧迫感	胸内苦悶
胸部圧迫感	胸部圧迫感,胸苦	胸内苦悶,胸部不快感
胸部孤立性陰影	胸部異常陰影	胸部異常陰影
胸部左側の痛み	左側胸部痛	側胸部痛
胸部打撲	胸部痛	胸痛
胸部異常影	胸部異常影,胸部陰影	胸部異常陰影
胸部異常映像	胸部異常陰影	胸部異常陰影
胸部異常陰影	胸部異常影,胸部異常陰影	胸部異常陰影
胸部疾患	胸部異常陰影	胸部異常陰影
胸部痛	全胸部痛,胸部圧迫感,胸痛	胸内苦悶,胸痛
胸部痛発作	胸痛発作	胸痛
胸部癌	胸部異常陰影	胸部異常陰影
胸部緊括感	胸部絞扼感	胸部不快感
胸郭圧迫	前胸部圧迫感	胸部不快感
脂肪肝	肝腫大	肝腫大
脂質異常	高LDH血症	
脇腹が痛い	左季肋部痛,右側腹部痛,左側腹部痛,左下腹部痛,側腹部痛,左側胸部痛,右下腹部痛,右側胸部痛	季肋部痛,側腹部痛,下腹痛,臍下部痛,側胸部痛,下腹痛,腸仙痛,胸痛
脇腹が痛む	側腹部痛	側腹部痛
脇腹の痛み	右下腹部痛,側腹部痛	下腹痛,腸仙痛,側腹部痛
脇腹痛	側腹部痛,左側腹部痛,左季肋部痛,左下腹部痛,右季肋部痛	側腹部痛,季肋部痛,下腹痛,臍下部痛
脈	血管雑音	動脈性雑音
脈が1分間に100回以上のとき	頻脈	頻脈症,洞頻脈
脈が1分間に60回以下のとき	徐脈	徐脈
脈が、早い	頻拍	頻拍症
脈がおかしい	徐脈,心電図異常	徐脈,心電図異常
脈がとても遅い	高度徐脈	徐脈
脈がとぶ	徐脈	徐脈
脈がはやい	頻脈	頻脈症,洞頻脈
脈がはやくなる	頻脈性不整脈	頻脈性不整脈
脈がゆっくり	徐脈	徐脈
脈が一定ではない	徐脈性不整脈	徐脈性不整脈
脈が乱れる	徐脈性不整脈,頻脈性不整脈,徐脈	徐脈性不整脈,頻脈性不整脈,徐脈
脈が多い	頻拍,頻脈	頻拍症,頻脈症,洞頻脈
脈が多いタイプの脈拍の乱れ	頻脈性不整脈	頻脈性不整脈
脈が少ない	徐脈	徐脈
脈が弱い	徐脈,洞性徐脈,頻脈	徐脈,洞徐脈,頻脈症,洞頻脈
脈が早い	頻拍,頻脈	頻拍症,頻脈症,洞頻脈
脈が早くなる	頻脈	頻脈症,洞頻脈
脈が激しい	頻拍	頻拍症
脈が異常	高度徐脈	徐脈
脈が良くない	頻脈性不整脈	頻脈性不整脈
脈が速い	頻脈,頻拍,徐脈	頻脈症,洞頻脈,頻拍症,徐脈
脈が速く	頻脈性不整脈	頻脈性不整脈
脈が速くなる	頻拍,頻脈	頻拍症,頻脈症,洞頻脈
脈が速く整っていない	頻脈性不整脈	頻脈性不整脈
脈が遅い	洞性頻脈（どうせいじょうみゃく）,洞性徐脈	洞徐脈
脈が遅くなる	徐脈,洞性徐脈	徐脈,洞徐脈
脈が遅くなる不整脈	徐脈性不整脈	徐脈性不整脈
脈が遅くなる症状	洞性徐脈	洞徐脈
脈が長い	洞性徐脈	洞徐脈
脈が頻繁	頻脈	頻脈症,洞頻脈
脈に異常	洞性頻脈（どうせいじょうみゃく）	
脈の乱れ	徐脈性不整脈,頻脈,動悸発作,徐脈	徐脈性不整脈,頻脈症,洞頻脈,動悸,徐脈
脈の具合がおかしい	洞性頻脈（どうせいじょうみゃく）	
脈の回数がゆっくり	徐脈	徐脈
脈の少ない不整脈	徐脈性不整脈	徐脈性不整脈
脈の異常	洞性徐脈	洞徐脈
脈の異常の一種	徐脈性不整脈	徐脈性不整脈
脈拍がおおいい	頻拍	頻拍症
脈拍がおかしい	高度徐脈,洞性徐脈	徐脈,洞徐脈
脈拍がかなりゆっくりな症状	高度徐脈	徐脈
脈拍が早い状態	頻拍	頻拍症
脈拍が早い症状	頻拍	頻拍症
脈拍の回数が早い	頻脈	頻脈症,洞頻脈
脈拍亢進	頻脈	頻脈症,洞頻脈
脈拍低下	頻脈	頻脈症,洞頻脈
脈拍多い	頻脈	頻脈症,洞頻脈
脈拍数が多い	頻脈	頻脈症,洞頻脈
脈拍数が少ない	徐脈	徐脈
脈拍数が異常に多い状態	頻脈	頻脈症,洞頻脈
脈拍数多い	頻拍	頻拍症
脈数低下	徐脈	徐脈
脊髄の外にできるしこり	髄外腫瘤	腫瘤
脚がだるい	下肢脱力	下肢脱力感
脚がむくむ	下腿浮腫	下腿浮腫
脚が腫れる	下肢浮腫	下肢浮腫
脚が膨張	下腿浮腫	下腿浮腫
脚に力が入らない	下肢脱力	下肢脱力感
脚のできもの	下腿浮腫	下腿浮腫
脚のむくみ	下腿浮腫,下肢浮腫	下腿浮腫,下肢浮腫
脚の痛み	下肢疼痛	疼痛
脚疼痛	下肢疼痛	疼痛
脚脱力	下肢脱力	下肢脱力感
脚部しびれ	下肢浮腫	下肢浮腫
脱力	右上肢脱力,虚脱,筋力低下,脱力,四肢筋力低下,四肢脱力	脱力感,虚脱,筋力低下,脱力感,筋脱力,四肢筋力低下,四肢脱力
脱力感	易疲労感,四肢脱力,脱力感	易疲労感,四肢脱力,脱力感
脱力状態	虚脱	虚脱
脱水症	口渇感	口渇症
脱水症状	口渇,口渇感	口渇症
脱腸	腹部リンパ節腫大	リンパ節腫大
脳が傷ついて言葉が出なくなる	失語症	失語症
脳しんとう	軽度意識障害	意識障害
脳と手足の中継地点を遮断されたように苦々しい	感覚障害	体感異常
脳に異常	頭蓋内病変	頭蓋内占拠性病変
脳の低下	意識レベルの低下	意識障害
脳の病的変化	頭蓋内病変	頭蓋内占拠性病変
脳出血	嚢胞内出血	内出血
脳卒中	血管雑音	動脈性雑音
脳悪性ガス	記憶障害	記憶障害
脳梗塞	呂律障害,失語症	構音障害,失語症
脳溢血	嚢胞内出血	内出血
脳神経障害	失神発作	失神
脳神経麻痺	右上肢脱力	脱力感
脳脊髄液中に蛋白が増加	蛋白細胞解離	髄液蛋白細胞数解離
脳腫瘍	腫瘍性病変,頚部腫瘤	-1,頚部腫瘤
脳震盪	一過性意識障害	一過性意識障害
脳髄液中のタンパク質上昇	蛋白細胞解離	髄液蛋白細胞数解離
脾腫	脾腫	脾腫
脾臓が拡大	脾腫	脾腫
脾臓が腫れている	脾腫	脾腫
脾臓が腫れる	脾腫	脾腫
脾臓が腫大	脾腫	脾腫
脾臓の疾患	脾腫	脾腫
脾臓の腫れ	脾腫	脾腫
脾臓の腫瘍	脾腫	脾腫
脾臓肥大	肝脾腫,脾腫	肝脾腫,脾腫
脾臓腫大	脾腫	脾腫
脾臓腫瘍	脾腫	脾腫
腎不全	両側下腿浮腫,蛋白尿,無尿	下腿浮腫,蛋白尿,無尿
腎機能障害	腎機能異常	腎機能検査異常
腎炎	低補体血症,無尿状態	低補体血症,無尿
腎疾患	低補体血症,血尿	低補体血症,血尿
腎臓がおかしい	腎機能異常	腎機能検査異常
腎臓が働かない	腎機能異常	腎機能検査異常
腎臓が悪い	腎機能異常	腎機能検査異常
腎臓が機能してない	腎機能異常	腎機能検査異常
腎臓が正常に機能しない症状	腎機能異常	腎機能検査異常
腎臓に機能の異常がある	腎機能異常	腎機能検査異常
腎臓の働きの異常	腎機能異常	腎機能検査異常
腎臓の機能が正常でないこと	腎機能異常	腎機能検査異常
腎臓の機能に異常がある	腎機能異常	腎機能検査異常
腎臓の機能に障害が見られる	腎機能異常	腎機能検査異常
腎臓の機能異常	腎機能異常	腎機能検査異常
腎臓劣化	大量腹水	腹水症
腎臓機能が悪い	腎機能異常	腎機能検査異常
腎臓機能の低下	腎機能異常	腎機能検査異常
腎臓機能障害	側腹部痛	側腹部痛
腎臓疾患	肉眼的血尿,無尿	肉眼的血尿,無尿
腎臓病	蛋白尿,黄疸,腎機能異常	蛋白尿,黄疸,腎機能検査異常
腎臓障害	排尿障害,高度蛋白尿	排尿障害,蛋白尿
腐った	壊死	壊死
腐ってる	壊死	壊死
腐って機能していない	壊死	壊死
腐って死ぬ	壊死	壊死
腐って組織が死ぬこと	壊死	壊死
腐っとる	壊死	壊死
腐る	壊死	壊死
腐れる	壊死	壊死
腐敗	壊死	壊死
腕と足に力が入らない	四肢脱力感	四肢脱力感
腕足に力が入らない	四肢脱力感	四肢脱力感
腕足のむくみ	四肢浮腫	四肢浮腫
腫れ	むくみ,腫大,腫瘤病変,頚部腫脹,丘疹,軽度腫大,左頚部リンパ節腫脹,腫瘤,膨満,浮腫,発赤	浮腫,リンパ節腫大,腫瘤,頚部腫脹,丘疹,頚部リンパ節腫脹,腹部膨満,発赤
腫れあがる	腫大	リンパ節腫大
腫れがおおきい	腫大	リンパ節腫大
腫れが大きい	腫瘤病変,巨大腫瘤	腫瘤
腫れが大きくなっている	浮腫状変化	浮腫
腫れが酷い	圧痕性浮腫	浮腫
腫れた	腫大,浮腫	リンパ節腫大,浮腫
腫れている	圧痕性浮腫	浮腫
腫れているが指で押してももとに戻らない	むくみ	浮腫
腫れてくる	浮腫性変化	浮腫
腫れてる	腫瘤	腫瘤
腫れて大きくなった肝臓	肝腫大	肝腫大
腫れに変わる	浮腫状変化	浮腫
腫れの軽い状態	軽度腫大	リンパ節腫大
腫れる	リンパ節腫大,リンパ節腫脹,浮腫	リンパ節腫大,浮腫
腫れ物	充実性腫瘤,腫瘤,嚢胞性腫瘤,腫瘍性病変,髄外腫瘤,腫大,多発リンパ節腫大,腫瘤病変,丘疹,浮腫,脾腫	腫瘤,-1,リンパ節腫大,丘疹,浮腫,脾腫
腫れ物が出来る	浮腫状変化	浮腫
腫れ物が大きくなる	軽度腫大	リンパ節腫大
腫れ物が現れること	浮腫性変化	浮腫
腫れ物の1つ	嚢胞性腫瘤	腫瘤
腫物	腫瘤,腫大	腫瘤,リンパ節腫大
腫物が大きい	腫大	リンパ節腫大
腫瘍	腫大,浮腫,リンパ節腫脹,髄外腫瘤,腫瘤,脾腫,腹腔内腫瘤,ｍａｓｓ,肺門リンパ節腫大,全身リンパ節腫大,全身性リンパ節腫脹,腫瘍性病変,頚部腫瘤	リンパ節腫大,浮腫,腫瘤,脾腫,腹腔内腫瘤,肺門リンパ節腫脹,リンパ節症,-1,頚部腫瘤
腫瘍ができること	腹部腫瘤	腹部腫瘤
腫瘍が何度もできる	多発腫瘤	腫瘤
腫瘍が多発する	多発腫瘤	腫瘤
腫瘍が悪性化	腫瘤病変	腫瘤
腫瘍が湧き出る	浮腫	浮腫
腫瘍の固まり	皮下腫瘤	皮下腫瘤
腫瘍の影	腫瘤像	腫瘤
腫瘍の映像	腫瘤像	腫瘤
腫瘍や瘤がたくさんできること	多発腫瘤	腫瘤
腫瘍マーカー	ＣＥＡ高値	ＣＥＡ高値
腫瘍マーカー上昇	ＣＥＡ高値	ＣＥＡ高値
腫瘍肥大	腫大	リンパ節腫大
腫瘤	ｍａｓｓ,腫瘍性病変,腫瘤形成	腫瘤,-1
腫瘤ができる	腫瘤形成	腫瘤
腫瘤が何個もできること	多発性腫瘤	腫瘤
腫瘤が複数の臓器でみられること	多発腫瘤	腫瘤
腫瘤が複数箇所に発症	多発性腫瘤	腫瘤
腫瘤と腫瘍の総称	腫瘤病変	腫瘤
腫瘤のこと	ｍａｓｓ	腫瘤
腫瘤の形	腫瘤像	腫瘤
腫瘤の状態が変わる	腫瘤病変	腫瘤
腫瘤映像	腫瘤像	腫瘤
腫瘤生病変	腫瘍性病変	-1
腫脹	腫大	リンパ節腫大
腰から下が痛い	下肢疼痛	疼痛
腰が重い	倦怠感	倦怠感
腰下肢痛	下肢疼痛	疼痛
腸がむくむ	腸管浮腫	浮腫
腸が浮腫む	腸管浮腫	浮腫
腸が腫れている状態	腸管浮腫	浮腫
腸管がむくむ	腸管浮腫	浮腫
腸管のむくみ	腸管浮腫	浮腫
腸管むくみ	腸管浮腫	浮腫
腸管壊死などの重篤な腹腔内疾患により出現する比較的まれな病態	門脈ガス血症	門脈ガス血症
腸重積	腸管浮腫,腹部腫瘤	浮腫,腹部腫瘤
腹いた	腹痛,腹部痛,腹痛発作,左上腹部痛,側腹部痛	腹痛症,腹壁痛,仙痛,腹痛症,上腹部痛,側腹部痛
腹いっぱい	腹満感	腹部膨満
腹がいたい	腹痛	腹痛症,腹壁痛,仙痛
腹がおかしい	腸管浮腫,腹部不快感,腹部違和感	浮腫,腹部不快感
腹がつっぱる	腹水貯留,腹満,腹部不快感	腹水症,腹部膨満,腹部不快感
腹がふくれた	腹部膨満	腹部膨満
腹がふくれて苦しい	腹部膨満感	腹部膨満
腹がふくれる感じ	腹部膨満感	腹部膨満
腹がふとる	腹満	腹部膨満
腹がもたれる	上腹部不快感	腹部不快感
腹が出る	腹部膨満	腹部膨満
腹が刺す	腹痛	腹痛症,腹壁痛,仙痛
腹が変な感じ	腹部違和感	腹部不快感
腹が張ってえらい	膨満,腹満感	腹部膨満
腹が張っとる気がする	腹満感	腹部膨満
腹が張る	腹部膨満,腹部膨満感,腹満	腹部膨満
腹が張る　	腹部膨満感	腹部膨満
腹が張る感じ	腹満感	腹部膨満
腹が痛い	急性腹症,腹痛,上腹部痛,下腹部痛,左側腹部痛	急性腹症,腹痛症,腹壁痛,仙痛,上腹部痛,下腹痛,側腹部痛
腹が腫れている	大量腹水	腹水症
腹が膨らむ	腹部膨満	腹部膨満
腹が膨らんだかんじ	腹部膨満	腹部膨満
腹が膨れた	腹部膨満	腹部膨満
腹が膨れた感じ	腹部膨満感	腹部膨満
腹が膨れている	腹満感	腹部膨満
腹が膨れる	腹部膨満,腹部膨隆,腹満	腹部膨満
腹が膨れる感じ	腹部膨満感	腹部膨満
腹が膨満する感じ	膨満	腹部膨満
腹が重苦しい	腹部膨満	腹部膨満
腹にこぶができる	腹部腫瘤	腹部腫瘤
腹にたくさん水たまる	大量腹水	腹水症
腹にみずがたまる	腹水	腹水症
腹にコブ	腹部腫瘤	腹部腫瘤
腹に不快な感じがすること	腹部不快感	腹部不快感
腹に何かある	腹部腫瘤	腹部腫瘤
腹に水がたまった	腹水	腹水症
腹に水がたまる	腹水,腹水貯留	腹水症
腹に水が溜まっとる	大量腹水	腹水症
腹に水が溜まる	腹水貯留	腹水症
腹に水が貯まる	腹水貯留	腹水症
腹に水貯まる	腹水	腹水症
腹に血が溜まる	血性腹水	血性腹水
腹に血の混じった水が溜まっとる	血性腹水	血性腹水
腹に血混じった水貯まる	血性腹水	血性腹水
腹に違和感がある	血性腹水	血性腹水
腹のしこり	腹部腫瘤	腹部腫瘤
腹のできもの	腹腔内腫瘤	腹腔内腫瘤
腹のもたれ	胃部不快感	腹部不快感
腹のリンパが大きくなる	腹部リンパ節腫大,腹腔内リンパ節腫大	リンパ節腫大
腹のリンパが腫れとる	腹腔内リンパ節腫脹	リンパ節腫大
腹のリンパが腫れる	腹腔内リンパ節腫大	リンパ節腫大
腹のリンパの腫れ	腹部リンパ節腫大	リンパ節腫大
腹の上の方が痛い	上腹部痛	上腹部痛
腹の上の方が腫れている	肝腫大	肝腫大
腹の上の方不快に感じる	上腹部不快感	腹部不快感
腹の下が痛い	下腹部痛	下腹痛
腹の下の方痛い	下腹部痛	下腹痛
腹の中が腫れているような気がする	腹腔内リンパ節腫大,腹腔内リンパ節腫脹	リンパ節腫大
腹の中に大きなできものが	腹部腫瘤	腹部腫瘤
腹の中のできもの	腹腔内腫瘤	腹腔内腫瘤
腹の中のリンパ大きくなる	腹腔内リンパ節腫大	リンパ節腫大
腹の中のリンパ腫れる	腹腔内リンパ節腫脹	リンパ節腫大
腹の右下痛い	右下腹部痛	下腹痛,腸仙痛
腹の右側痛い	右側腹部痛	側腹部痛
腹の左上が痛い	左上腹部痛	上腹部痛
腹の左上の痛み	左上腹部痛	上腹部痛
腹の異常	腹部腫瘤	腹部腫瘤
腹の突起物	腹部膨隆	腹部膨満
腹の腫瘍	腹部腫瘤	腹部腫瘤
腹の膨らみ	腹部膨隆	腹部膨満
腹の調子がおかしい	胃部不快感	腹部不快感
腹の違和感	腹部違和感	腹部不快感
腹や胃のはりもたれ	腹部違和感	腹部不快感
腹を触られると力が入る	筋性防御	筋性防御
腹一杯	膨満,腹部膨満	腹部膨満
腹側面の痛み	側腹部痛	側腹部痛
腹内のリンパ節がはれた	腹腔内リンパ節腫脹	リンパ節腫大
腹水	血性腹水,腹部膨隆,腹水貯留,腹部膨満,胸腹水	血性腹水,腹部膨満,腹水症
腹水がたくさん溜まっている	大量腹水	腹水症
腹水がたまる	大量腹水,腹水貯留	腹水症
腹水が溜まりやすい	難治性腹水	難治性腹水
腹水が溜まる	血性腹水,腹水貯留	血性腹水,腹水症
腹水が血液であること	血性腹水	血性腹水
腹水が貯まる	腹水貯留	腹水症
腹水に血液が混ざっている	血性腹水	血性腹水
腹水多量	大量腹水	腹水症
腹水貯留	腹水貯留	腹水症
腹痛	下腹部痛,上腹部痛,左側腹部痛,腹部痛,左下腹部痛,右側腹部痛,右下腹部痛,左季肋部痛,右上腹部痛,腹部不快感,腹痛発作,腹部違和感,左上腹部痛,側腹部痛,上腹部不快感,心窩部痛,急性腹症,腹痛,筋性防御,右季肋部痛	下腹痛,上腹部痛,側腹部痛,腹痛症,下腹痛,臍下部痛,下腹痛,腸仙痛,季肋部痛,腹部不快感,心窩部痛,急性腹症,腹痛症,腹壁痛,仙痛,筋性防御
腹痛い	腹痛	腹痛症,腹壁痛,仙痛
腹痛と発作	腹痛発作	腹痛症
腹痛症状	腹痛発作	腹痛症
腹痛（はらいた）	腹痛	腹痛症,腹壁痛,仙痛
腹腔の内側に腫瘍の塊がある病気	腹腔内腫瘤	腹腔内腫瘤
腹腔ガン	腹腔内腫瘤	腹腔内腫瘤
腹腔内リンパ節腫脹	腹腔内リンパ節腫大	リンパ節腫大
腹膜に水が溜まる	腹水貯留	腹水症
腹膜刺激症状	筋性防御	筋性防御
腹膜炎	難治性腹水	難治性腹水
腹違	腹痛	腹痛症,腹壁痛,仙痛
腹部が重い	腹部不快感	腹部不快感
腹部しこり	腹腔内腫瘤	腹腔内腫瘤
腹部にできた腫瘤	腹部腫瘤	腹部腫瘤
腹部にコブが出来ること	腹部腫瘤	腹部腫瘤
腹部に水がたまる	大量腹水	腹水症
腹部に水が溜まる	腹水	腹水症
腹部に溜まった水	腹水	腹水症
腹部に血まじりの水が貯まること##	血性腹水	血性腹水
腹部に違和感	腹部不快感	腹部不快感
腹部に陰がある	胸部異常陰影	胸部異常陰影
腹部のしこり	腹部腫瘤	腹部腫瘤
腹部のリンパにしこりができる	腹腔内リンパ節腫脹	リンパ節腫大
腹部のリンパ線が腫れること	腹腔内リンパ節腫脹	リンパ節腫大
腹部の上の方の痛み	上腹部痛	上腹部痛
腹部の上部の不快感	上腹部不快感	腹部不快感
腹部の下の方の痛み	下腹部痛	下腹痛
腹部の右上が痛むこと	右上腹部痛	上腹部痛
腹部の吐き気や痛み	腹部不快感	腹部不快感
腹部の痛み	腹痛	腹痛症,腹壁痛,仙痛
腹部の腫れ	腹部膨満感	腹部膨満
腹部の腫れ物	腹腔内リンパ節腫脹,腹部腫瘤,腹腔内リンパ節腫大	リンパ節腫大,腹部腫瘤
腹部の腫瘍	腹腔内腫瘤	腹腔内腫瘤
腹部はり	腹満	腹部膨満
腹部リンパ節腫れ	腹部リンパ節腫大	リンパ節腫大
腹部リンパ腫	腹部リンパ節腫大	リンパ節腫大
腹部上部の痛み	上腹部痛	上腹部痛
腹部不快感	腹部違和感	腹部不快感
腹部不振	膨満	腹部膨満
腹部体液	腹水	腹水症
腹部全体あるいは局所的にガスや腹水などで腹部が膨隆した状態	腹部膨隆	腹部膨満
腹部右側の痛み	右上腹部痛	上腹部痛
腹部張り	腹部膨満	腹部膨満
腹部疼痛	腹痛	腹痛症,腹壁痛,仙痛
腹部痛	腹痛発作,腹部痛	腹痛症
腹部腫瘍	腹腔内腫瘤	腹腔内腫瘤
腹部腫瘤	腹腔内腫瘤	腹腔内腫瘤
腹部膨張	腹部膨隆	腹部膨満
腹部膨張感	腹部膨満感	腹部膨満
腹部膨満	腹部膨隆,腹部膨満,腹腔内腫瘤,腹部腫瘤,腹満	腹部膨満,腹腔内腫瘤,腹部腫瘤
腹部膨満感	腹満感,腹満,腹部不快感,膨満	腹部膨満,腹部不快感
腹部触診時に腹筋の緊張によって抵抗が発生する	筋性防御	筋性防御
腿がむくむ	両側下腿浮腫	下腿浮腫
膀胱に尿が送られず	無尿	無尿
膀胱のあたりが腫れている	傍大動脈リンパ節腫大	リンパ節腫大
膀胱炎	排尿時痛,排尿障害,尿閉,膵腫大,無尿状態,頻尿,血尿	排尿痛,排尿障害,尿閉,膵腫大,無尿,多尿,頻尿症,血尿
膀胱硬化	夜間頻尿	夜間頻尿症
膝から下がむくんでいる	両側下腿浮腫	下腿浮腫
膝から下のむくみ	下腿浮腫	下腿浮腫
膠原病	全身性炎症反応症候群,低補体血症	全身性炎症反応症候群,低補体血症
膨らみ	膨満	腹部膨満
膨らむ	膨満	腹部膨満
膨れあがり	脾腫	脾腫
膨れる	膨満	腹部膨満
膨れる感じ	膨満	腹部膨満
膨張	膨満	腹部膨満
膨満	腹満,腹満感	腹部膨満
膨満感	腹部違和感,腹満,腹満感,腹部不快感,腹部膨隆,上腹部不快感,膨満,胃部不快感	腹部不快感,腹部膨満
膵仮性嚢胞	膵性胸水	胸水検査異常
膵炎	膵腫大,高アミラーゼ血症	膵腫大,高アミラーゼ血症
膵炎に胸水が合併	膵性胸水	胸水検査異常
膵腫大	膵腫大	膵腫大
膵腫瘍	膵腫大	膵腫大
膵臓から何らかの原因で肺に水がたまること	膵性胸水	胸水検査異常
膵臓が大きくなる	膵腫大	膵腫大
膵臓が弱って胸に水がたまっている	膵性胸水	胸水検査異常
膵臓が拡大	膵腫大	膵腫大
膵臓が腫れている	膵腫大	膵腫大
膵臓が腫れてる	膵腫大	膵腫大
膵臓が腫れて壁の厚みが厚くなっている状態	膵腫大	膵腫大
膵臓が腫れて大きくなっている	膵腫大	膵腫大
膵臓が腫れて大きくなってる	膵腫大	膵腫大
膵臓が腫れる	膵腫大	膵腫大
膵臓にある大きい主要	膵腫大	膵腫大
膵臓に水が溜まる	膵性胸水	胸水検査異常
膵臓のできもの	膵腫大	膵腫大
膵臓のはれ	膵腫大	膵腫大
膵臓の病気のせいで胸に水がたまる	膵性胸水	胸水検査異常
膵臓の腫れ	膵腫大	膵腫大
膵臓炎	左側腹部痛	側腹部痛
膵臓肥大	膵腫大	膵腫大
膵臓腫瘍肥大	膵腫大	膵腫大
膿	浮腫性変化,皮下腫瘤,肝腫大	浮腫,皮下腫瘤,肝腫大
膿のこぶ	腫瘤	腫瘤
膿の混じった痰	膿性痰	膿性痰
膿を伴う痰	膿性痰	膿性痰
膿を含んだ痰	膿性痰	膿性痰
膿を含んだ痰が出る	膿性痰	膿性痰
膿性の痰	膿性痰	膿性痰
膿疱	嚢胞性腫瘤	腫瘤
臓が膨れて厚みがある	膵腫大	膵腫大
臓器が動かなくなる	多臓器不全	多臓器不全
臓器が大きくなること	腫大	リンパ節腫大
臓器が正常に働いていない	多臓器不全	多臓器不全
臓器が腫れる	腫大	リンパ節腫大
臓器など体のぶぶんが死ぬ	壊死	壊死
臓器の腫れ	腫大	リンパ節腫大
自分がいる場所がわからない	見当識障害	見当識障害
自分がわからない	見当識障害	見当識障害
自分で息できない	労作時呼吸困難	労作時呼吸困難
自分で食事を摂ることは難しい状態。	経口摂取困難	経口摂取困難
自分の名前が書けない	記銘力障害	記銘力低下,記憶障害
自分の意思と関係なしに勝手に身体が動く	不随意運動	不随意運動症
自分の意思に関係なくしびれること	けいれん	痙攣
自分の言いたいことを表現できない	運動性失語	運動性失語症
自制できず力が入りすぎること	こわばり	こわばり
自力で歩けない	歩行障害	歩行障害
自己炎症性疾患	周期性発熱	発熱
自律神経失調症	異常行動,味覚障害	異常行動,味覚障害
自律神経老化	頻尿	多尿,頻尿症
自発呼吸不全	呼吸筋麻痺	呼吸麻痺
自発呼吸困難	拘束性換気障害	拘束性換気障害
自発的に生じる異常な感覚	痺れ	しびれ感
舌がうまく回らない	呂律不良	不明瞭言語
舌がまわらない	呂律不良	不明瞭言語
舌がもつれる	呂律不良	不明瞭言語
舌が回らない	呂律困難,呂律不良,呂律障害	構音障害,不明瞭言語
舌が回らない障害	呂律障害	構音障害
舌が馬鹿	味覚障害	味覚障害
舌老化	味覚異常,味覚障害	味覚異常,味覚障害
舌運動障害	呂律不良	不明瞭言語
舌音痴	味覚障害	味覚障害
良く分からない時が	意識障害	意識障害
良性腫	低エコー腫瘤	腫瘤
色々な臓器が動かなくなる	多臓器不全	多臓器不全
色の濃いおしっこ	褐色尿	ビリルビン尿
色の濃い尿	褐色尿	ビリルビン尿
色素変色	黄疸	黄疸
若干発熱	微熱	微熱
苦しい	呼吸苦,肺出血,低酸素血症,労作時呼吸困難,肺浸潤影,呼吸困難感,胸痛発作,嚥下障害,胸苦,呼吸困難,胸部絞扼感,心雑音,痛み,胸痛,しびれ	呼吸促迫,呼吸困難,肺出血,低酸素血症,労作時呼吸困難,肺部異常陰影,呼吸麻痺,胸痛,嚥下障害,胸部不快感,呼吸困難,心雑音,疼痛,しびれ感
苦痛	痛み,激痛	疼痛
茶色い尿	褐色尿	ビリルビン尿
茶色のおしっこ	褐色尿	ビリルビン尿
茶色の尿	褐色尿	ビリルビン尿
荒い呼吸	頻呼吸	頻呼吸
萎縮	固縮	こわばり
落ちる	落屑	鱗屑
蓄膿症	膿性痰	膿性痰
蕁麻疹	全身性炎症反応症候群,発疹,びまん性粒状影	全身性炎症反応症候群,発疹,胸部異常陰影
薄い影	スリガラス様陰影	胸部異常陰影
虚弱	摂食不良	摂食機能障害
虚無	虚脱	虚脱
虚脱感	脱力感,四肢脱力感,四肢脱力,四肢筋力低下	脱力感,四肢脱力感,四肢脱力,四肢筋力低下
虫垂炎	右下腹部痛	下腹痛,腸仙痛
蛋白	蛋白尿	蛋白尿
蛋白が出る	蛋白尿	蛋白尿
蛋白が降りている	高度蛋白尿,尿蛋白	蛋白尿
蛋白の混じった尿	蛋白尿	蛋白尿
蛋白量過多尿	高度蛋白尿	蛋白尿
蝶形紅斑	発赤	発赤
血がいっぱい出た	大量出血	多量出血
血がいっぱい出る	大量出血	多量出血
血がいっぱい流れて命が危ない	出血性ショック	出血性ショック
血がでた	出血,出血性ショック	出血,出血性ショック
血がでる	出血	出血
血がどろどろ	高ＣＫ血症,高LDH血症	高クレアチンキナーゼ血症,
血がまじる	潜血	顕微鏡的血尿
血がまた出る	再出血	出血
血がドロドロ	高ＡＬＰ血症	高アルカリホスファターゼ血症
血が上手く回らん	循環不全	急性循環不全,末梢循環不全
血が入ったタン	血痰	血痰
血が再び出る	再出血	出血
血が出た	出血,潜血	出血,顕微鏡的血尿
血が出てもうた	再出血	出血
血が出てる	出血	出血
血が出てショック状態	出血性ショック	出血性ショック
血が出て倒れる	出血性ショック	出血性ショック
血が出る	出血,点状出血	出血,点状出血
血が出ること	出血	出血
血が出続けている	活動性出血	出血
血が出過ぎて痙攣	出血性ショック	出血性ショック
血が回らない	循環不全	急性循環不全,末梢循環不全
血が大量に出る	大量出血	多量出血
血が循環できない	循環不全	急性循環不全,末梢循環不全
血が止まったのにまた出た	再出血	出血
血が止まったのに再び出血すること	再出血	出血
血が止まらない	出血	出血
血が沢山出る	大量出血	多量出血
血が流れる	出血	出血
血が混ざった痰	血痰	血痰
血が混ざっている	潜血	顕微鏡的血尿
血が混じった水がお腹にたまる	血性腹水	血性腹水
血が混じった痰	血痰	血痰
血が混じっている	潜血	顕微鏡的血尿
血が混じっている痰	血痰	血痰
血が混じってる痰	血痰	血痰
血が混じる	潜血,肉眼的血尿,尿潜血,血痰,血尿	顕微鏡的血尿,肉眼的血尿,血痰,血尿
血が混じること	潜血	顕微鏡的血尿
血が混じる痰	血痰	血痰
血が滞る	循環不全	急性循環不全,末梢循環不全
血が潜んでる	潜血	顕微鏡的血尿
血が甘い	高血糖	高血糖症
血が騒ぐ	血管雑音	動脈性雑音
血のしょんべん	血尿	血尿
血のまざったたん	血痰	血痰
血のような色の尿が出る	血尿	血尿
血のタン	血痰	血痰
血のビルビリンが多い	高ビリルビン血症	高ビリルビン血症
血の回りがわるい	循環不全	急性循環不全,末梢循環不全
血の固まり	潜血	顕微鏡的血尿
血の塊が出来ている	点状出血	点状出血
血の巡りが悪い	末梢循環不全,循環不全	末梢循環不全,急性循環不全,末梢循環不全
血の巡りが悪い異なる	循環不全	急性循環不全,末梢循環不全
血の巡りが悪くなる	循環不全	急性循環不全,末梢循環不全
血の循環が悪くなり支障をきたす	出血性ショック	出血性ショック
血の成分がおかしい	高血糖,低酸素血症	高血糖症,低酸素血症
血の気がない	顔色不良	顔面蒼白
血の流れる音に雑音が混ざっている	血管雑音	動脈性雑音
血の混じったおしっこ	血尿	血尿
血の混じったたん	血痰	血痰
血の混じった便	タール便	黒色便
血の混じった尿	血尿	血尿
血の混じった淡	血痰	血痰
血の混じった痰	血痰	血痰
血の混じってる腹水	血性腹水	血性腹水
血の混じり	潜血	顕微鏡的血尿
血の異常	低補体血症	低補体血症
血の病気の一種	高炭酸ガス血症	高炭酸ガス血症
血の痰	血痰	血痰
血の跡がある	出血斑	斑状出血
血まめ	嚢胞内出血	内出血
血みどろ	出血性ショック	出血性ショック
血をはく	喀血	喀血
血を吐く	喀血,血痰,肺出血	喀血,血痰,肺出血
血を含んだ痰	血痰	血痰
血を流しすぎて気を失う	出血性ショック	出血性ショック
血を見て気分が悪い	出血性ショック	出血性ショック
血中のLDHが高い	高LDH血症	
血中のckpが高い状態	高ＣＰＫ血症	高クレアチンキナーゼ血症
血中アミラーゼ上昇	高アミラーゼ血症	高アミラーゼ血症
血中アルカリフォスファターゼ上昇	高ＡＬＰ血症	高アルカリホスファターゼ血症
血中クレアチンキナーゼ値が高い	高ＣＫ血症	高クレアチンキナーゼ血症
血中ビリルビン濃度が高い	高ビリルビン血症	高ビリルビン血症
血中乳酸値が正常値より高い症状	高乳酸血症	高乳酸血症
血中二酸化炭素の濃度が上がる	CO２ナルコーシス	
血中炭酸ガス濃度が高い状態	高炭酸ガス血症	高炭酸ガス血症
血中酸素	動脈血ガス	血液ガス値異常
血中酸素濃度低下	チアノーゼ	チアノーゼ
血便	黒色便,潜血,タール便	黒色便,顕微鏡的血尿
血便の一種	黒色便	黒色便
血出た	出血	出血
血圧が高い	高血糖,高ビリルビン血症	高血糖症,高ビリルビン血症
血尿	尿潜血,褐色尿,黒色便,肉眼的血尿,血尿	顕微鏡的血尿,ビリルビン尿,黒色便,肉眼的血尿,血尿
血栓	末梢循環不全,血痰	末梢循環不全,血痰
血流が悪い	循環不全	急性循環不全,末梢循環不全
血流が悪い状態	循環不全	急性循環不全,末梢循環不全
血流の異常音	血管雑音	動脈性雑音
血流異常	動悸発作	動悸
血流障害	高ＣＫ血症,循環不全	高クレアチンキナーゼ血症,急性循環不全,末梢循環不全
血液	潜血	顕微鏡的血尿
血液がでる	出血	出血
血液がどろどろ	高LDH血症	
血液がどろどろしている	高ＣＰＫ血症	高クレアチンキナーゼ血症
血液が体内にたまること	血性腹水	血性腹水
血液が全身にいきわたらない	循環不全	急性循環不全,末梢循環不全
血液が大量に体外に出ること	大量出血	多量出血
血液が流れにくい	洞性頻脈（どうせいじょうみゃく）	
血液に問題がある	高ＩｇＧ４血症	ＩｇＧ４関連疾患,高ＩｇＧ血症
血液に腹水が混在した状態	血性腹水	血性腹水
血液の循環がうまくいかない	循環不全	急性循環不全,末梢循環不全
血液の混じった痰	血痰	血痰
血液の通っていない状態	壊死	壊死
血液ドロドロ	高血糖	高血糖症
血液中に二酸化炭素が多い状態	CO２ナルコーシス	
血液中のCPKが高い	高ＣＰＫ血症	高クレアチンキナーゼ血症
血液中のIgEが多い	高ＩｇＥ血症	高ＩｇＥ血症
血液中のLDHが高い	高LDH血症	
血液中のさんそが低い	低酸素血症	低酸素血症
血液中のアミラーゼが高くなる	高アミラーゼ血症	高アミラーゼ血症
血液中のブドウ糖濃度が高い	高血糖	高血糖症
血液中の乳酸が多い	高乳酸血症	高乳酸血症
血液中の二酸化炭素が多い	高二酸化炭素血症	高炭酸ガス血症
血液中の二酸化炭素が著しく増加した状態	高炭酸ガス血症	高炭酸ガス血症
血液中の二酸化炭素の濃度が著しく増加した状態	高炭酸ガス血症	高炭酸ガス血症
血液中の抗体がたくさんある症状	抗体価上昇	抗体価上昇
血液中の脂質の数値が高い症状	高LDH血症	
血液中の酸素濃度が低い	低酸素血症	低酸素血症
血液中の酸素量が低い状態	低酸素血症	低酸素血症
血混じりのおしっこ	血尿	血尿
血混じりのにょう	肉眼的血尿	肉眼的血尿
血混じりの尿	尿潜血	顕微鏡的血尿
血清中の補体成分が低下する症状	低補体血症	低補体血症
血痰	喀痰	喀痰
血管がよく流れない	血管雑音	動脈性雑音
血管に雑音が聞こえる	血管雑音	動脈性雑音
血管の一種	洞性頻脈（どうせいじょうみゃく）,高度徐脈,徐脈,頻脈	徐脈,頻脈症,洞頻脈
血管の雑音	血管雑音	動脈性雑音
血管異常	血管雑音	動脈性雑音
血管破裂	再出血	出血
血管老化	徐脈性不整脈,点状出血	徐脈性不整脈,点状出血
血糖が高い	高血糖	高血糖症
血糖値が上がる	食後高血糖	高血糖症
血糖値が普通よりも高め	耐糖能異常	耐糖能異常
血糖値が正常より高い状態	耐糖能異常	耐糖能異常
血糖値が高い	高血糖,耐糖能異常	高血糖症,耐糖能異常
血糖値が高め	高血糖	高血糖症
血糖値のコントロールが自分できないこと	耐糖能障害	耐糖能異常
血糖値上昇	高血糖	高血糖症
血糖値高め	耐糖能異常	耐糖能異常
血糖異常	耐糖能異常	耐糖能異常
血色の悪い	顔色不良	顔面蒼白
血色不良	顔色不良	顔面蒼白
血行不良	末梢循環不全,高二酸化炭素血症,痺れ	末梢循環不全,高炭酸ガス血症,しびれ感
血行障害	末梢循環不全,痺れ	末梢循環不全,しびれ感
血豆	皮下出血斑	皮下出血
行動がおかしい	異常行動	異常行動
行動が変になる	異常行動	異常行動
被爆	線状影	胸部異常陰影
複数のリンパ節が腫れる	多発リンパ節腫大	リンパ節腫大
複数の内臓が危険	多臓器障害	多臓器不全
複数の内臓機能に問題がおきる	多臓器障害	多臓器不全
複数の臓器がおかしい	多臓器不全	多臓器不全
複数の臓器に機能障害	多臓器不全	多臓器不全
複数の臓器に障害がある	多臓器障害	多臓器不全
複数の臓器の不具合	多臓器不全	多臓器不全
複数の臓器の動きが悪くなる	多臓器不全	多臓器不全
複数の臓器の異常	多臓器障害	多臓器不全
複数の臓器不能	多臓器不全	多臓器不全
複数臓器不全	多臓器障害	多臓器不全
複数臓器機能障害	多臓器不全	多臓器不全
褐色のオシッコ	褐色尿	ビリルビン尿
褐色の尿	褐色尿	ビリルビン尿
褐色の尿が出ること	褐色尿	ビリルビン尿
覆水盆に返らず	大量腹水	腹水症
見えてないものが見える	幻覚	幻覚
見えないものが見える状態	幻覚	幻覚
見える血尿	肉眼的血尿	肉眼的血尿
見た目がチーズに似た細胞の死体	乾酪壊死	壊死
見た目にはわからないがおしっこに少し血が混じっている状態	顕微鏡的血尿	顕微鏡的血尿
見てわからない血尿	尿潜血	顕微鏡的血尿
見るからにおしっこに血が混じっている	肉眼的血尿	肉眼的血尿
見当識	意識混濁,意識障害	意識混濁,意識障害
見当識異常	見当識障害	見当識障害
見当識障害	見当識障害	見当識障害
見当違い	見当識障害	見当識障害
規則的で遅い脈	洞性徐脈	洞徐脈
視界が揺れること	眩暈	めまい
視界が暗いこと	眼前暗黒感	眼前暗黒
視界が暗くなる	眼前暗黒感	眼前暗黒
視界が暗くなること	眼前暗黒感	眼前暗黒
覚えが悪くなる	記銘力障害	記銘力低下,記憶障害
覚えておくことができなくなる障害	記銘力障害	記銘力低下,記憶障害
覚えてない症状	記憶障害	記憶障害
覚えられない	記憶障害	記憶障害
覚えることができない	記憶障害	記憶障害
覚える能力の低下	記銘力低下	記銘力低下
観戦異常	末梢循環不全	末梢循環不全
角質	落屑	鱗屑
触ると少し痛い	軽度圧痛	圧痛
言い間違えること	失語	失語症
言葉がうまく発せられない	呂律不良	不明瞭言語
言葉がきれいに発音できない	呂律不良	不明瞭言語
言葉がでない	失語	失語症
言葉がはっきりとしゃべれない症状	呂律不良	不明瞭言語
言葉がはっきり話せない	呂律困難	構音障害
言葉が上手く構成できない	構語障害	構語障害
言葉が出てこない	失語症,失語	失語症
言葉が出て来ない	失語	失語症
言葉が出ない	失語,失語症,運動性失語,構語障害,呂律障害	失語症,運動性失語症,構語障害,構音障害
言葉が出なくなる	失語症,失語	失語症
言葉が出にくい	失語症	失語症
言葉が変だ	構語障害	構語障害
言葉が思うようにうまく出てこない	失語症	失語症
言葉が発せない	失語症	失語症
言葉が発せられない	失語症	失語症
言葉が話せない	失語	失語症
言葉が話せなくなる	失語症	失語症
言葉の異常	構語障害	構語障害
言葉を口から発せない	失語	失語症
言葉を忘れた	失語症,失語	失語症
言葉を忘れる	失語症	失語症
言葉を発しようと思ってもでない	失語	失語症
言葉を話せない	失語	失語症
言葉忘れ	失語症	失語症
言語がおかしい	失語症	失語症
言語機能の低下	失語	失語症
言語障害	構音障害,構語障害,失語,失語症,呂律困難,呂律障害,呂律不良	構音障害,構語障害,失語症,不明瞭言語
記憶があいまいになる	物忘れ	健忘症
記憶がおかしくなる	記憶障害	記憶障害
記憶がない	記憶障害,意識障害	記憶障害,意識障害
記憶が困難	記憶障害	記憶障害
記憶が思い出せない	記憶障害	記憶障害
記憶が曖昧	記憶障害	記憶障害
記憶が曖昧になる	記憶障害	記憶障害
記憶が無くなる	意識消失	意識消失
記憶が飛ぶ	失神発作	失神
記憶が飛んだ	意識消失	意識消失
記憶に問題がおきる	記憶障害	記憶障害
記憶に障害があること	記銘力障害	記銘力低下,記憶障害
記憶力の低下	記銘力障害,物忘れ	記銘力低下,記憶障害,健忘症
記憶力低下	記銘力低下	記銘力低下
記憶力減退	意識レベル低下	意識障害
記憶力障害	記銘力障害	記銘力低下,記憶障害
記憶喪失	記憶障害,記銘力障害	記憶障害,記銘力低下,記憶障害
記憶消失	意識消失	意識消失
記憶障害	記銘力障害,物忘れ,記銘力低下	記銘力低下,記憶障害,健忘症,記銘力低下
記銘力障害	記銘力低下	記銘力低下
話しかけても答えられない状態	意識消失	意識消失
話しができない	失語	失語症
話し方が上手くいかない	呂律困難	構音障害
話すことが出来ない	構語障害	構語障害
話す状態の異常	失語	失語症
話せない	失語	失語症
話そうとしても言葉が出ない	失語	失語症
話をすることが困難	構語障害	構語障害
認知しづらい	知覚障害	知覚障害
認知しにくい	知覚障害	知覚障害
認知機能低下	記銘力障害	記銘力低下,記憶障害
認知症	見当識障害,記銘力障害,記銘力低下,物忘れ	見当識障害,記銘力低下,記憶障害,記銘力低下,健忘症
認識障害	意識障害	意識障害
誤嚥	嚥下機能障害	嚥下協調障害,嚥下障害
誤飲	嚥下障害	嚥下障害
謎の発熱	不明熱	不明熱
負荷があった部分がはれる	圧痕性浮腫	浮腫
貧尿	尿閉,乏尿	尿閉,乏尿
貧血	顔色不良,低補体血症,チアノーゼ,末梢循環不全,一過性意識障害	顔面蒼白,低補体血症,チアノーゼ,末梢循環不全,一過性意識障害
質量	ｍａｓｓ	腫瘤
赤あざ	出血斑	斑状出血
赤いおしっこ	肉眼的血尿	肉眼的血尿
赤いできものが広がる	発赤腫脹	発赤
赤いはれもの	発赤	発赤
赤いぶつぶつができる	発疹	発疹
赤いブツブツ	発赤	発赤
赤い尿	褐色尿	ビリルビン尿
赤い斑点	点状出血,出血斑	点状出血,斑状出血
赤い痣	出血斑	斑状出血
赤い発疹	発赤	発赤
赤い盛り上がった発疹	紅色丘疹	紅色丘疹
赤い腫れ物	発赤腫脹	発赤
赤い腫れ物が現れること	発赤腫脹	発赤
赤く、盛り上がったようにはれる	紅色丘疹	紅色丘疹
赤くただれる	発赤	発赤
赤くなってかゆい	紅色丘疹	紅色丘疹
赤くなってる	発赤	発赤
赤くなる	発赤	発赤
赤くなること	発赤腫脹	発赤
赤くなる状態	発赤	発赤
赤くはれた	発赤腫脹	発赤
赤くはれる	発赤腫脹	発赤
赤くむくむ	発赤腫脹	発赤
赤く腫れてる	発赤腫脹	発赤
赤く腫れる	発赤腫脹,皮疹	発赤,発疹
赤く腫れること	発赤腫脹	発赤
赤たん	出血斑	斑状出血
赤み	紅色丘疹,点状出血	紅色丘疹,点状出血
赤みが出る	発赤	発赤
赤みが増している	発赤腫脹	発赤
赤ら顔	発赤	発赤
赤出	出血	出血
赤化	発赤	発赤
赤斑点	発赤	発赤
起きてる状態の呼吸	起坐呼吸	起坐呼吸
起き上がって息をする	起坐呼吸	起坐呼吸
起坐呼吸	労作時呼吸困難,労作時呼吸困難感	労作時呼吸困難
足あざ	下肢浮腫	下肢浮腫
足がうずく	下肢疼痛	疼痛
足がうずくように痛い	下肢疼痛	疼痛
足がずきずき痛む	下肢疼痛	疼痛
足がだるい	下肢脱力感,下肢脱力	下肢脱力感
足がむくむ	下腿浮腫,下肢浮腫,浮腫性変化	下腿浮腫,下肢浮腫,浮腫
足がむくむこと	下腿浮腫	下腿浮腫
足がむくんだ	両下肢浮腫	下肢浮腫
足がむくんでいる	下肢浮腫	下肢浮腫
足がジンジン痛む	下肢疼痛	疼痛
足がズキズキ	下肢疼痛	疼痛
足がズキズキすること	下肢疼痛	疼痛
足が仮死	下腿浮腫	下腿浮腫
足が動かしにくい	四肢筋力低下	四肢筋力低下
足が弱る	四肢筋力低下	四肢筋力低下
足が疼く痛み	下肢疼痛	疼痛
足が痛い	下肢疼痛,左側胸部痛	疼痛,側胸部痛
足が腫れている	両下肢浮腫,下肢浮腫	下肢浮腫
足などの末梢の血液循環が悪い	末梢循環不全	末梢循環不全
足に力が入らない	下肢脱力感,下肢脱力,四肢脱力	下肢脱力感,四肢脱力
足に力が入らないこと	下肢脱力	下肢脱力感
足に力が入らない感じ	下肢脱力感	下肢脱力感
足に力が入りづらい	下肢脱力感	下肢脱力感
足のかゆみ	下肢疼痛	疼痛
足のしびれだるさ	下肢脱力感	下肢脱力感
足のむくみ	下肢浮腫,下腿浮腫,両側下腿浮腫,両下腿浮腫,両下肢浮腫,左下腿浮腫	下肢浮腫,下腿浮腫
足のももの内側が腫れている	両下腿浮腫	下腿浮腫
足のズキズキ	下肢疼痛	疼痛
足の両側が腫れている	両側下腿浮腫	下腿浮腫
足の力が入らない	下肢脱力	下肢脱力感
足の浮腫	下肢浮腫	下肢浮腫
足の浮腫み	両下肢浮腫,下腿浮腫	下肢浮腫,下腿浮腫
足の痛み	下肢疼痛	疼痛
足の筋力が落ちる	四肢筋力低下	四肢筋力低下
足の筋力が衰える	四肢筋力低下	四肢筋力低下
足の脱力感	下肢脱力感	下肢脱力感
足の腫れ	下肢浮腫	下肢浮腫
足の血管腫	下腿浮腫	下腿浮腫
足や脚の痛み	下肢疼痛	疼痛
足を脱力する	下肢脱力	下肢脱力感
足元がおぼつかない	ふらつき	めまい
足元がおぼつく	ふらつき	めまい
足元がふらつく	失調性歩行	失調性歩行
足元が定まらない	ふらつき	めまい
足取りが覚束ない	ふらつき	めまい
足脱力	四肢脱力	四肢脱力
身体から力がぬける	虚脱	虚脱
身体があつい	高熱	高熱
身体がだるい	全身倦怠感,四肢脱力	全身倦怠感,四肢脱力
身体がひきつる	痙攣	痙攣
身体がガタガタピクピクする	けいれん	痙攣
身体がビクビクする	痙攣	痙攣
身体が重い	倦怠感,全身倦怠感	倦怠感,全身倦怠感
身体が黄色になる	黄疸	黄疸
身体に力が入らない	四肢脱力,四肢筋力低下	四肢脱力,四肢筋力低下
身体に嫌悪感	全身倦怠感	全身倦怠感
身体のむくみ	全身浮腫	全身性浮腫
身体の力が抜ける	四肢脱力	四肢脱力
身体の感覚がなくなるようなめまい	浮動性めまい	めまい
身体の末梢循環が不具合になる	末梢循環不全	末梢循環不全
身体の痛み	全身痛	全身痛
身体の真ん中が不快	心窩部不快感	心窩部不快
身体の筋肉が持続的に強くこわばること	固縮	こわばり
身体の重さが増える	体重増加	体重増加
身体を動かしたときの呼吸困難	労作時息切れ	息切れ
身体中がむくむ	全身浮腫	全身性浮腫
身体中が痙攣すること	全身性痙攣	全身痙攣
身体中が痛い	全身痛	全身痛
身体中に水がたまってむくんでいる	全身リンパ節腫大	リンパ節腫大
身体中の節々が腫れている	全身性リンパ節腫脹	リンパ節症
身体全体に炎症が起きる	全身性炎症反応症候群	全身性炎症反応症候群
身体全体のリンパ節が腫れたり大きくなったりする	全身性リンパ節腫脹	リンパ節症
身体全部が痙攣すること	全身性痙攣	全身痙攣
身体硬直	硬結	硬結
身震い	振戦	振戦
軟便	タール便	黒色便
転びやすい	姿勢反射障害	姿勢異常
転びやすい障害	姿勢反射障害	姿勢異常
転倒し易くなった状態	姿勢反射障害	姿勢異常
軽いむくみ	軽度腫大	リンパ節腫大
軽いもうろう状態	軽度意識障害	意識障害
軽い圧痛	軽度圧痛	圧痛
軽い圧迫による痛み	軽度圧痛	圧痛
軽い圧迫感の痛み	軽度圧痛	圧痛
軽い大きな腫物	軽度腫大	リンパ節腫大
軽い意識レベルの低下	軽度意識障害	意識障害
軽い意識喪失	軽度意識障害	意識障害
軽い意識障害	軽度意識障害	意識障害
軽い打ち身	軽度圧痛	圧痛
軽い打撲	軽度圧痛	圧痛
軽い熱	微熱	微熱
軽い疲れ	易疲労感	易疲労感
軽い症状の意識がない	軽度意識障害	意識障害
軽い痛み	軽度圧痛	圧痛
軽い痛みがあること	軽度圧痛	圧痛
軽い発熱	微熱	微熱
軽い目眩	意識レベル低下	意識障害
軽い腫れ	軽度腫大	リンパ節腫大
軽い膨れ	軽度腫大	リンパ節腫大
軽い臓器の腫れ	軽度腫大	リンパ節腫大
軽い記憶喪失	軽度意識障害	意識障害
軽く圧迫されたような痛み	軽度圧痛	圧痛
軽く意識が曖昧	軽度意識障害	意識障害
軽く意識の明晰さなどが失われる状態	軽度意識障害	意識障害
軽く押されてような痛み	軽度圧痛	圧痛
軽度の圧迫したときに感じる痛み	軽度圧痛	圧痛
軽度の意識混濁	軽度意識障害	意識障害
軽度の意識相が出る	軽度意識障害	意識障害
軽度の発熱	微熱	微熱
軽度疲労	易疲労感	易疲労感
軽度腫れ	軽度腫大	リンパ節腫大
辛い	痛み	疼痛
逆流性胃腸炎	胸部不快感	胸部不快感
途切れ途切れ	労作時息切れ	息切れ
通常で胸が痛い	安静時胸痛	反復性胸痛,胸痛
通常の意識状態ではない	意識レベル低下	意識障害
通常より大きくなったリンパ節	腫大リンパ節	リンパ節腫大
通常時胸痛	安静時胸痛	反復性胸痛,胸痛
連続的な呼吸が困難	息切れ	息切れ
運動したり重いものをもったりしたときに呼吸が苦しくなること	労作性呼吸困難	発作性呼吸困難,労作時呼吸困難
運動した後言葉が出ない	運動性失語	運動性失語症
運動していないときの胸の痛み	安静時胸痛	反復性胸痛,胸痛
運動していない状態での呼吸困難	安静時呼吸困難	呼吸困難
運動して一時的に言葉が出なくなる	運動性失語	運動性失語症
運動不足	寡動	行動緩慢
運動中の息切れ	労作時呼吸苦	労作時呼吸困難
運動喘息	労作時呼吸困難感	労作時呼吸困難
運動失調	失調性歩行	失調性歩行
運動性失語症	運動性失語	運動性失語症
運動時に胸が痛む	労作時胸痛	反復性胸痛,胸痛
運動時の呼吸が難しい	労作時呼吸困難感	労作時呼吸困難
運動時の息切れ	労作時呼吸困難感	労作時呼吸困難
運動時の胸の痛み	労作時胸痛	反復性胸痛,胸痛
運動異常	運動性失語	運動性失語症
過体重	体重増加	体重増加
過呼吸	頻呼吸,呼吸筋麻痺,運動性失語,労作時呼吸苦,労作性呼吸困難,喘鳴,けいれん発作,呼吸困難,労作時呼吸困難,低酸素血症,呼吸苦,動悸,呼吸困難感	頻呼吸,呼吸麻痺,運動性失語症,労作時呼吸困難,発作性呼吸困難,労作時呼吸困難,喘鳴,てんかん様発作,痙攣発作,痙攣重積発作,全身痙攣発作,呼吸困難,低酸素血症,呼吸促迫,呼吸困難,動悸
過呼吸症候群	CO２ナルコーシス	
過多蛋白質	高度蛋白尿	蛋白尿
過換気	頻呼吸,呼吸困難	頻呼吸,呼吸困難
過敏症	異常感覚	異常触覚,異常知覚
違和感	異常感覚,腹部不快感	異常触覚,異常知覚,腹部不快感
違和感がある	皮下結節　,浮腫	浮腫
部分壊死	乾酪壊死	壊死
部分的に固まる	項部硬直	項部硬直
酒の飲み過ぎ	肝機能異常	肝機能検査異常
酩酊状態	意識レベル低下,ふらつき	意識障害,めまい
酵素が異常	高アミラーゼ血症	高アミラーゼ血症
酸欠	高二酸化炭素血症,低酸素血症	高炭酸ガス血症,低酸素血症
酸欠状態	低酸素血症	低酸素血症
酸素が足りていないこと	チアノーゼ	チアノーゼ
酸素不足	低酸素血症,高二酸化炭素血症,チアノーゼ,呼吸困難	低酸素血症,高炭酸ガス血症,チアノーゼ,呼吸困難
酸素不足で肌の色が変わる	チアノーゼ	チアノーゼ
酸素供給量の不足	安静時呼吸困難	呼吸困難
酸素欠乏	CO２ナルコーシス,チアノーゼ,低酸素血症,しびれ感	チアノーゼ,低酸素血症,しびれ感
酸素欠乏症	低酸素血症	低酸素血症
酸素濃度が下がる	低酸素血症	低酸素血症
酸素濃度が低い	低酸素血症	低酸素血症
重い	全身倦怠感	全身倦怠感
重い痙攣	痙攣重積状態	痙攣重積発作
重い痙攣が続く	痙攣重積状態	痙攣重積発作
重い痛み	鈍痛	鈍痛
重なった腫れもの	多発腫瘤,多発性腫瘤	腫瘤
重心を崩したときに片方の足を出してバランスを保つ機能が働かない症状	姿勢反射障害	姿勢異常
重症の呼吸不全を呈する	びまん性肺胞出血	肺胞出血
重症動悸	頻拍	頻拍症
重痛い	鈍痛	鈍痛
重苦しい痛み	鈍痛	鈍痛
針にさされたような感覚	異常感覚	異常触覚,異常知覚
鈍い傷みがあること	鈍痛	鈍痛
鈍い動き	寡動	行動緩慢
鈍い痛み	鈍痛	鈍痛
鈍感	温痛覚低下	知覚鈍麻
鈍痛	圧痛	圧痛
鋭通	激痛	疼痛
錯感覚	異常感覚	異常触覚,異常知覚
長い間咳がで続けていること	慢性咳嗽	慢性咳嗽
長く続くせき症状	慢性咳嗽	慢性咳嗽
長引く咳	慢性咳嗽	慢性咳嗽
長引く風邪	慢性咳嗽	慢性咳嗽
門脈を通る血液中の気体比率の異常	門脈ガス血症	門脈ガス血症
門脈ガスに血が出てる	門脈ガス血症	門脈ガス血症
門脈ガス血症	門脈ガス血症,肺胞出血	門脈ガス血症,肺胞出血
門脈内にガスが認められる状態	門脈ガス血症	門脈ガス血症
門脈気腫	門脈ガス血症	門脈ガス血症
門脈気腫症	門脈ガス血症	門脈ガス血症
門脈血流省が	門脈ガス血症	門脈ガス血症
開放骨折	ｆｉｎｅ　ｃｒａｃｋｌｅｓ	湿性ラ音
間質影	スリガラス影,スリガラス陰影,スリガラス様陰影	胸部異常陰影
間質性肺炎	スリガラス影	胸部異常陰影
間質性肺炎肺炎	スリガラス陰影	胸部異常陰影
関心度が落ちる	意識レベル低下	意識障害
関節などの痛み	疼痛	疼痛
関節リウマチ	皮下結節　	
陰	線状影	胸部異常陰影
陰影	スリガラス様陰影	胸部異常陰影
陰部からの出血	性器出血	性器出血
陰部出血	性器出血	性器出血
集中力不足	意識レベル低下	意識障害
雑音	血管雑音	動脈性雑音
震え	痙攣,振戦,安静時振戦,手指振戦,悪寒,けいれん,全身性痙攣	痙攣,振戦,静止時振戦,手指振戦,悪寒,全身痙攣
震えてる	けいれん	痙攣
震える	振戦,手指振戦	振戦,手指振戦
震えること	けいれん	痙攣
青あざ	皮下出血斑,皮下出血,出血斑	皮下出血,斑状出血
青あざが出来ている	皮下出血	皮下出血
青ざめた状態	チアノーゼ	チアノーゼ
青たん	出血斑,皮下出血,皮下出血斑	斑状出血,皮下出血
青アザ	出血斑,皮下出血斑	斑状出血,皮下出血
青タン	皮下出血斑,皮下出血	皮下出血
青紫	チアノーゼ	チアノーゼ
青色	顔色不良	顔面蒼白
静かにしているときの胸の痛み	安静時胸痛	反復性胸痛,胸痛
静かにしているのに呼吸できない	安静時呼吸困難	呼吸困難
静かにしているのに胸が痛い	安静時胸痛	反復性胸痛,胸痛
静かに横になっていても呼吸が難しい状態	安静時呼吸困難	呼吸困難
静かに横になっていても胸が痛い	安静時胸痛	反復性胸痛,胸痛
静かに横になっているときに、胸が痛む症状	安静時胸痛	反復性胸痛,胸痛
静脈	徐脈,頻脈	徐脈,頻脈症,洞頻脈
静脈瘤	頚部腫瘤	頚部腫瘤
静脈血栓塞栓症	下肢浮腫	下肢浮腫
非回転性めまい	めまい感	めまい感
非常にはげしい痛み	激痛	疼痛
非常に痛い	激痛	疼痛
音がよく聞き取れない	構音障害	構音障害
音を聞くのが難しい状態	構音障害	構音障害
項部が固まった	項部硬直	項部硬直
項部硬直	項部硬直	項部硬直
頓死	突然死	突然死
頚のシコリ	頚部腫瘤	頚部腫瘤
頚のリンパ腺の腫れ	腹部リンパ節腫大,頚部リンパ節腫脹	リンパ節腫大,頚部リンパ節腫脹
頚の腫れ	左頚部リンパ節腫脹	頚部リンパ節腫脹
頚左のリンパ腺の腫れ	左頚部リンパ節腫脹	頚部リンパ節腫脹
頚部の腫れ	頚部腫脹	頚部腫脹
頚部リンパ節腫れ	頚部リンパ節腫大	頚部リンパ節腫脹
頭いた	頭痛,頭部痛	頭痛
頭おもい	頭重感	頭重感
頭から足先までの痙攣	全身性痙攣	全身痙攣
頭がいたい	頭痛	頭痛
頭がえらい	頭重感	頭重感
頭ががんがんする	頭痛	頭痛
頭がじんじんする	頭痛	頭痛
頭がずきずきする	頭痛	頭痛
頭がガンガンする	拍動性頭痛,頭痛	頭痛
頭が働かない	知覚障害	知覚障害
頭が思い感じ	頭重感	頭重感
頭が痛い	頭痛,頭部痛,拍動性頭痛,疼痛	頭痛,疼痛
頭が痛いこと	頭部痛,頭痛	頭痛
頭が痛い状態	頭痛	頭痛
頭が痛む	頭部痛,頭痛	頭痛
頭が脈をうっている	拍動性頭痛	頭痛
頭が重い	頭重感,頭痛,頭部痛	頭重感,頭痛
頭が重い感じ	頭重感	頭重感
頭が重い感じがする	頭重感	頭重感
頭が重い状態	頭重感	頭重感
頭が重たい感じ	頭重感	頭重感
頭が重苦しい	頭重感	頭重感
頭に糖分が回らない	耐糖能障害	耐糖能異常
頭のてっぺんが痛い	項部硬直	項部硬直
頭の前が痛いこと	全胸部痛	
頭の後が痛くなること	後頭部痛	後頭部痛
頭の後ろがいたい	後頭部痛	後頭部痛
頭の後ろが痛い	後頭部痛	後頭部痛
頭の後ろのほうが痛い	後頭部痛	後頭部痛
頭の後ろの方が痛い	後頭部痛	後頭部痛
頭の後ろの方の痛み	後頭部痛	後頭部痛
頭の後ろの方痛い	後頭部痛	後頭部痛
頭の後ろの痛み	後頭部痛	後頭部痛
頭の後ろの部分が痛いこと	後頭部痛	後頭部痛
頭の後ろ側が痛い	後頭部痛	後頭部痛
頭の良性腫瘍	髄外腫瘤	腫瘤
頭の血腫	頭蓋内病変	頭蓋内占拠性病変
頭の骨の中に病気の部分がある症状	頭蓋内病変	頭蓋内占拠性病変
頭の骨の中の病気	頭蓋内病変	頭蓋内占拠性病変
頭イタ	頭部痛	頭痛
頭病め	頭痛	頭痛
頭痛	頭部痛,拍動性頭痛,後頭部痛,頭重感,癌性疼痛,疼痛,嚥下痛,めまい感,発熱	頭痛,後頭部痛,頭重感,癌性疼痛,疼痛,嚥下痛,めまい感,発熱
頭痛い	頭痛,頭部痛	頭痛
頭痛（あたまいた）	頭痛	頭痛
頭蓋内障害	頭蓋内病変	頭蓋内占拠性病変
頭蓋骨の中に問題がある	頭蓋内病変	頭蓋内占拠性病変
頭蓋骨の中に異常がある	頭蓋内病変	頭蓋内占拠性病変
頭蓋骨の中の病気	頭蓋内病変	頭蓋内占拠性病変
頭蓋骨の内側に病気がある	頭蓋内病変	頭蓋内占拠性病変
頭蓋骨内部に病気による異変があること	頭蓋内病変	頭蓋内占拠性病変
頭部が重い感じ	頭重感	頭重感
頭部に感じる内部の痛み	頭痛	頭痛
頭部の痛み	頭痛	頭痛
頭部ガン	髄外腫瘤	腫瘤
頭部リンパの炎症	頸部リンパ節腫大	頚部リンパ節腫脹
頭部痛	頭痛	頭痛
頭骨内異変	頭蓋内病変	頭蓋内占拠性病変
頸のリンパが腫れ上がっている	頸部リンパ節腫大	頚部リンパ節腫脹
頸椎ガン	頚部腫瘤	頚部腫瘤
頸癌	頚部腫脹	頚部腫脹
頸部に形成される腫瘤	頚部腫瘤	頚部腫瘤
頸部のリンパの腫物大きくなる	頸部リンパ節腫大,頚部リンパ節腫大	頚部リンパ節腫脹
頸部の腫れ	頚部リンパ節腫脹,頸部リンパ節腫大,頚部腫瘤	頚部リンパ節腫脹,頚部腫瘤
頸部の腫物	頚部腫瘤	頚部腫瘤
頸部リンパ節の腫れ	左頚部リンパ節腫脹	頚部リンパ節腫脹
頸部リンパ節腫れ	頸部リンパ節腫大,頚部リンパ節腫脹	頚部リンパ節腫脹
頸部リンパ節腫脹	頚部腫脹,頚部リンパ節腫脹	頚部腫脹,頚部リンパ節腫脹
頻回に咳が出る	慢性咳嗽	慢性咳嗽
頻尿	多尿,多飲多尿,夜間頻尿,排尿障害,尿閉,無尿状態	多尿,多飲症,多尿,夜間頻尿症,排尿障害,尿閉,無尿
頻尿で眠れない	夜間頻尿	夜間頻尿症
頻拍	房室回帰性頻拍,頻脈	頻拍症,頻脈症,洞頻脈
頻繁にトイレに行く	頻尿	多尿,頻尿症
頻脈	頻拍,頻脈性不整脈,拍動性頭痛,頻脈,動悸,動悸発作	頻拍症,頻脈性不整脈,頭痛,頻脈症,洞頻脈,動悸
頻脈性不整脈	頻脈	頻脈症,洞頻脈
額が熱い	発熱	発熱
顎のリンパが腫れる	頚部リンパ節腫脹	頚部リンパ節腫脹
顎のリンパ線の腫れ	頚部リンパ節腫脹	頚部リンパ節腫脹
顔がむくむ	顔面浮腫	顔面浮腫
顔がむくんでる	顔面浮腫	顔面浮腫
顔が引きつってる	こわばり	こわばり
顔が浮く	顔面浮腫	顔面浮腫
顔が腫れている	顔面浮腫	顔面浮腫
顔が腫れる	顔面浮腫	顔面浮腫
顔が赤くなる	発赤	発赤
顔が黄色くなっている	黄疸	黄疸
顔のできもの	顔面浮腫	顔面浮腫
顔のむくみ	顔面浮腫	顔面浮腫
顔の浮腫み	顔面浮腫	顔面浮腫
顔の腫れ	顔面浮腫	顔面浮腫
顔の色が普通と違う	顔色不良	顔面蒼白
顔むくみ	顔面浮腫	顔面浮腫
顔色がおかしい	チアノーゼ	チアノーゼ
顔色がよくない	顔色不良	顔面蒼白
顔色がわるか	チアノーゼ	チアノーゼ
顔色が悪い	顔色不良	顔面蒼白
顔色が悪いこと	顔色不良	顔面蒼白
顔色が悪い状態	顔色不良	顔面蒼白
顔色が黄色い	黄染	黄疸
顔色の悪さ	顔色不良	顔面蒼白
顔色悪い	顔色不良	顔面蒼白
顔面の膨張	顔面浮腫	顔面浮腫
顔面むくみ	顔面浮腫	顔面浮腫
顔面浮腫	顔面浮腫	顔面浮腫
顔面神経痛	顔面浮腫	顔面浮腫
顔面紅潮	紅色丘疹	紅色丘疹
顔面蒼白	顔色不良,低酸素血症	顔面蒼白,低酸素血症
顔面麻痺	顔面浮腫	顔面浮腫
顕微鏡で見て解る血の混じったおしっこ	顕微鏡的血尿	顕微鏡的血尿
風味がおかしい	異常感覚	異常触覚,異常知覚
風邪	咳,熱,高熱,発熱	咳,発熱,高熱
風邪の初め	悪寒	悪寒
風邪の症状	咳	咳
飛び飛びに血が出る	点状出血	点状出血
食	急性腹症	急性腹症
食う気がしない	食欲不振	食欲不振
食う気せえへん	食思不振	食欲不振
食えない	経口摂取不良	摂食機能障害
食が細い	食欲不振,食思不振	食欲不振
食が進まない	食欲不振,食欲低下,食思不振	食欲不振
食べすぎ	腹部膨満,腹部膨隆	腹部膨満
食べたあとに血糖値があがること	食後高血糖	高血糖症
食べたあと血糖値が上がりやすい	食後高血糖	高血糖症
食べたいと思わない	食思不振	食欲不振
食べたいものが思い付かない	食思不振	食欲不振
食べたい気が起きない	食欲低下	食欲不振
食べたい気持ちがさがる	食欲低下	食欲不振
食べたい気持ちが起こらない	食欲不振	食欲不振
食べたくない	食欲不振,食思不振,食欲低下,摂食不良	食欲不振,摂食機能障害
食べたくなくなった	食欲低下	食欲不振
食べたくなくなっている	食欲低下	食欲不振
食べたくなくなる	食欲不振	食欲不振
食べた後に血糖値が上がる	食後高血糖	高血糖症
食べた後血糖値が上がる	食後高血糖	高血糖症
食べた後血糖値が高くなる	食後高血糖	高血糖症
食べにくい	経口摂取不良	摂食機能障害
食べようと思わない	食思不振	食欲不振
食べられない	経口摂取不良,摂食不良,嚥下機能障害,食欲不振	摂食機能障害,嚥下協調障害,嚥下障害,食欲不振
食べられなくなる	摂食不良	摂食機能障害
食べることができない	摂食不良	摂食機能障害
食べることが出来ない	摂食不良	摂食機能障害
食べると血圧上がる	食後高血糖	高血糖症
食べる意欲がない	食欲不振	食欲不振
食べる気がおこらない	食欲不振	食欲不振
食べる気がしない	食思不振,食欲低下,食欲不振	食欲不振
食べる気が起きない	食思不振,食欲低下	食欲不振
食べる気にならない	食思不振	食欲不振
食べる気力がわかない	食欲低下	食欲不振
食べる気力が湧かない	食欲不振	食欲不振
食べる気持ちが減ってしまう事	食欲低下	食欲不振
食べれない	摂食不良	摂食機能障害
食べ物がなかなか食べられなくなる	食欲低下	食欲不振
食べ物が呑み込めない	嚥下障害	嚥下障害
食べ物が喉につまる	嚥下困難	嚥下困難
食べ物が喉を通り辛い	経口摂取不良	摂食機能障害
食べ物を上手に飲み込めない状態	嚥下困難	嚥下困難
食べ物を食べたいと思わない	食思不振	食欲不振
食べ物を飲み込むのに支障がある	嚥下機能障害	嚥下協調障害,嚥下障害
食べ物を飲み込めない	嚥下障害	嚥下障害
食べ過ぎ	膨満	腹部膨満
食事か進まない	食欲不振	食欲不振
食事ができない	摂食不良,食欲低下	摂食機能障害,食欲不振
食事がとれない	摂食不良	摂食機能障害
食事が進まない	摂食不良	摂食機能障害
食事が食べられない	食思不振	食欲不振
食事の後に血糖値が上がる	食後高血糖	高血糖症
食事の後の高血糖	食後高血糖	高血糖症
食事の後血の糖度高い	食後高血糖	高血糖症
食事をほとんどとらなくなってしまう拒食症	摂食不良	摂食機能障害
食事不全	摂食不良	摂食機能障害
食事後に血圧が高くなること	食後高血糖	高血糖症
食事後に高血糖になる	食後高血糖	高血糖症
食後に血糖値が上がる	食後高血糖	高血糖症
食後に血糖値が上がること	食後高血糖	高血糖症
食後に血糖値が基準値以上に上がる	食後高血糖	高血糖症
食後に血糖値が急上昇	食後高血糖	高血糖症
食後に血糖値が高くなる	食後高血糖	高血糖症
食後の血糖値が高い	食後高血糖	高血糖症
食後血糖値が上がる	食後高血糖	高血糖症
食後血糖値上昇	食後高血糖	高血糖症
食後高血糖	耐糖能異常	耐糖能異常
食欲あれへん	食欲低下	食欲不振
食欲があまりない	食欲低下	食欲不振
食欲がおちる	食欲低下	食欲不振
食欲がていか	食思不振	食欲不振
食欲がない	食欲不振,食欲低下,摂食不良,食思不振	食欲不振,摂食機能障害
食欲がないこと	食思不振,食欲不振	食欲不振
食欲がなくなってきた	食欲低下	食欲不振
食欲がなくなる	食欲低下	食欲不振
食欲がなく食べれない	食思不振	食欲不振
食欲がわかない	食欲低下,食思不振,食欲不振	食欲不振
食欲が下がること	食欲低下	食欲不振
食欲が以前に比べて低下	食欲低下	食欲不振
食欲が低い	食欲低下	食欲不振
食欲が無い	食欲不振,摂食不良,食思不振,食欲低下	食欲不振,摂食機能障害
食欲が無い状態	食欲不振	食欲不振
食欲が落ちた	食欲低下	食欲不振
食欲が落ちる	食欲低下	食欲不振
食欲が起きない	食欲不振	食欲不振
食欲ない	食欲不振	食欲不振
食欲なし	食欲不振	食欲不振
食欲不全	摂食不良	摂食機能障害
食欲不振	食思不振,食欲低下,摂食不良,体重減少	食欲不振,摂食機能障害,体重減少
食欲不良	食思不振,食欲不振,食欲低下	食欲不振
食欲低下	食思不振,食欲不振	食欲不振
食欲減退	食欲不振,食思不振,食欲低下	食欲不振
食欲湧かない	食思不振,食欲不振,食欲低下	食欲不振
食物や水分を口から出してしまう	吐き気	嘔気
食用がない	食思不振	食欲不振
食道の異常	嚥下障害	嚥下障害
食道炎	嚥下機能障害	嚥下協調障害,嚥下障害
飯が喉を通らない	嚥下障害	嚥下障害
飯を食いたくない	食思不振,食欲低下	食欲不振
飲みこむ時に痛い	嚥下痛	嚥下痛
飲みすぎておしっこがたくさん出ること	多飲多尿	多飲症,多尿
飲みすぎる	多飲	多飲症
飲み込みができない	嚥下困難,嚥下困難感	嚥下困難
飲み込みずらい	嚥下機能障害	嚥下協調障害,嚥下障害
飲み込みづらい	嚥下困難感,嚥下困難,嚥下機能障害	嚥下困難,嚥下協調障害,嚥下障害
飲み込みできない	嚥下障害	嚥下障害
飲み込みにくい	嚥下障害,嚥下困難,嚥下困難感,嚥下機能障害	嚥下障害,嚥下困難,嚥下協調障害,嚥下障害
飲み込みにくく感じる	嚥下困難感	嚥下困難
飲み込みにくさ	嚥下困難,嚥下障害	嚥下困難,嚥下障害
飲み込みに問題がある	嚥下機能障害	嚥下協調障害,嚥下障害
飲み込み不全	嚥下障害	嚥下障害
飲み込み困難	嚥下障害,嚥下困難	嚥下障害,嚥下困難
飲み込み時に痛みがある	嚥下痛	嚥下痛
飲み込み辛い	嚥下障害	嚥下障害
飲み込み障害	嚥下機能障害,嚥下困難感	嚥下協調障害,嚥下障害,嚥下困難
飲み込み難い	嚥下障害	嚥下障害
飲み込むことができない	嚥下困難,嚥下障害	嚥下困難,嚥下障害
飲み込むことが難しくなる	嚥下機能障害	嚥下協調障害,嚥下障害
飲み込むことに関する障害	嚥下機能障害	嚥下協調障害,嚥下障害
飲み込むづらい感じ	嚥下困難感	嚥下困難
飲み込むときに喉が痛い	嚥下痛	嚥下痛
飲み込むときに痛い	嚥下痛	嚥下痛
飲み込むときに痛みがある	嚥下痛	嚥下痛
飲み込むときに痛みがあること	嚥下痛	嚥下痛
飲み込むとき痛い	嚥下痛	嚥下痛
飲み込むと痛い	嚥下痛	嚥下痛
飲み込むのが困難	嚥下機能障害,嚥下困難,嚥下障害	嚥下協調障害,嚥下障害,嚥下困難,嚥下障害
飲み込むのが難しい	嚥下困難,嚥下障害	嚥下困難,嚥下障害
飲み込むのが難しいと感じる	嚥下困難感	嚥下困難
飲み込むの時痛い	嚥下痛	嚥下痛
飲み込む力がよわくなる	嚥下困難感	嚥下困難
飲み込む時につっかえる	嚥下障害	嚥下障害
飲み込む時に痛くなること	嚥下痛	嚥下痛
飲み込む時の喉の痛み	嚥下痛	嚥下痛
飲み込む時の痛み	嚥下痛	嚥下痛
飲み込む機能が衰えること	嚥下機能障害	嚥下協調障害,嚥下障害
飲み込む機能の障害	嚥下機能障害	嚥下協調障害,嚥下障害
飲み込む際に間違って気道に入る	嚥下障害	嚥下障害
飲み込めない	嚥下機能障害,嚥下障害,嚥下困難,嚥下困難感,経口摂取困難	嚥下協調障害,嚥下障害,嚥下障害,嚥下困難,経口摂取困難
飲み込めなくなる	嚥下機能障害,嚥下障害	嚥下協調障害,嚥下障害,嚥下障害
飲み込めへん	嚥下障害	嚥下障害
飲み過ぎ	多飲	多飲症
飲み過ぎで尿がたくさんでる	多飲多尿	多飲症,多尿
飲み過ぎで尿が近いこと	多飲多尿	多飲症,多尿
飲む量も多く尿の出る量も多い	多飲多尿	多飲症,多尿
飲めない	嚥下困難,嚥下困難感	嚥下困難
飲んだり食べたりするのに違和感がある	嚥下困難	嚥下困難
飲水量が多くて多尿を来す状態	多飲	多飲症
飲食障害	経口摂取不良	摂食機能障害
首あたりの腫れ	頚部腫脹	頚部腫脹
首がはれた	頚部リンパ節腫脹	頚部リンパ節腫脹
首がパンパンで動かない	項部硬直	項部硬直
首が腫れる	頚部リンパ節腫脹,頚部腫脹	頚部リンパ節腫脹,頚部腫脹
首にあるリンパ節の腫れ	頚部リンパ節腫脹	頚部リンパ節腫脹
首にこぶができている	頚部腫脹	頚部腫脹
首にできたおでき	頚部腫瘤	頚部腫瘤
首にできものができる	頚部腫瘤	頚部腫瘤
首に癌ができること	頚部腫脹	頚部腫脹
首のあたりがグリグリと腫れている	頚部リンパ節腫脹	頚部リンパ節腫脹
首のあたりの痛み	後頭部痛	後頭部痛
首のこぶ	頚部腫脹	頚部腫脹
首のしこり	頚部腫脹,頚部腫瘤,頚部リンパ節腫脹	頚部腫脹,頚部腫瘤,頚部リンパ節腫脹
首のできもの	頚部腫瘤	頚部腫瘤
首のグリグリ	左頚部リンパ節腫脹	頚部リンパ節腫脹
首のデキモノ	頚部腫瘤	頚部腫瘤
首のリンパが大きくなる	頸部リンパ節腫大	頚部リンパ節腫脹
首のリンパが腫れた	頚部リンパ節腫大	頚部リンパ節腫脹
首のリンパが腫れる	頚部リンパ節腫脹	頚部リンパ節腫脹
首のリンパのガン	頚部リンパ節腫脹	頚部リンパ節腫脹
首のリンパの腫れ	頚部リンパ節腫大,頚部リンパ節腫脹	頚部リンパ節腫脹
首のリンパ節が1cm以上	頚部リンパ節腫脹	頚部リンパ節腫脹
首のリンパ節がはれ上がること	頚部リンパ節腫脹	頚部リンパ節腫脹
首のリンパ節が腫れている	頚部リンパ節腫脹	頚部リンパ節腫脹
首のリンパ節が腫れる	頚部リンパ節腫大,頚部リンパ節腫脹	頚部リンパ節腫脹
首のリンパ節に腫瘍が見つかった	頸部リンパ節腫大	頚部リンパ節腫脹
首のリンパ節の腫れ	頸部リンパ節腫大,頚部リンパ節腫大	頚部リンパ節腫脹
首の付け根のリンパ節が腫れて大きくなる症状	頸部リンパ節腫大,頚部リンパ節腫大	頚部リンパ節腫脹
首の偏頭痛	後頭部痛	後頭部痛
首の左リンパが腫れる	左頚部リンパ節腫脹	頚部リンパ節腫脹
首の左側のリンパ腫がはれる	左頚部リンパ節腫脹	頚部リンパ節腫脹
首の後が腫れている	頸部リンパ節腫大	頚部リンパ節腫脹
首の後ろが腫れている	頚部リンパ節腫脹,頚部リンパ節腫大	頚部リンパ節腫脹
首の後ろのリンパ腺が腫れている	頚部リンパ節腫脹	頚部リンパ節腫脹
首の腫れ	頚部リンパ節腫脹,頚部腫瘤,頸部リンパ節腫大,頚部リンパ節腫大	頚部リンパ節腫脹,頚部腫瘤
首の部分が腫れる	頚部腫脹	頚部腫脹
首の部分のリンパ節が腫れて大きくなること	頸部リンパ節腫大,頚部リンパ節腫大	頚部リンパ節腫脹
首リンパ節の腫れ	頚部リンパ節腫脹	頚部リンパ節腫脹
首筋のリンパ腺が腫れてる	頚部リンパ節腫脹	頚部リンパ節腫脹
骨盤上部のリンパ節の腫れ	傍大動脈リンパ節腫大	リンパ節腫大
骨肉腫	髄外腫瘤	腫瘤
骨髄腫	髄外腫瘤	腫瘤
髄液が流れる管の外側にこぶができている	髄外腫瘤	腫瘤
髄膜刺激症候	項部硬直	項部硬直
髄膜刺激症状	項部硬直	項部硬直
高い体温	高熱	高熱
高い炭酸ガスの血症	高炭酸ガス血症	高炭酸ガス血症
高い熱	高熱	高熱
高い熱が出た	発熱	発熱
高い熱が出る	高熱	高熱
高アルカリフォスファターゼ血症	高ＡＬＰ血症	高アルカリホスファターゼ血症
高カリウム血漿	高ＡＬＰ血症	高アルカリホスファターゼ血症
高ガンマグロブリン血症	抗体価上昇	抗体価上昇
高クレアチニンキナーゼ血症	高ＣＫ血症	高クレアチンキナーゼ血症
高グロブリン血症	高ＩｇＧ４血症	ＩｇＧ４関連疾患,高ＩｇＧ血症
高コレステロール症	高LDH血症	
高コレステロール血症	高LDH血症	
高タンパク症	高ＩｇＥ血症	高ＩｇＥ血症
高体温	熱発,高熱,微熱	発熱,高熱,微熱
高山病	低酸素血症	低酸素血症
高度に脈が少ない状態	高度徐脈	徐脈
高度の脈拍低下	高度徐脈	徐脈
高度意識障害	昏迷	昏迷
高次脳機能障害	記銘力障害,失語	記銘力低下,記憶障害,失語症
高温	発熱	発熱
高温熱	高熱	高熱
高熱	発熱,高熱	発熱,高熱
高脂血症	高LDH血症,高ＩｇＧ血症,高ＩｇＥ血症,高ＩｇＧ４血症,高ＡＬＰ血症,高ＣＫ血症,高アミラーゼ血症	高ＩｇＧ血症,高ＩｇＥ血症,ＩｇＧ４関連疾患,高ＩｇＧ血症,高アルカリホスファターゼ血症,高クレアチンキナーゼ血症,高アミラーゼ血症
高脂質症	高LDH血症	
高血圧	高ＩｇＧ４血症,高LDH血症,高ＩｇＧ血症,高血糖,高ＣＫ血症	ＩｇＧ４関連疾患,高ＩｇＧ血症,高ＩｇＧ血症,高血糖症,高クレアチンキナーゼ血症
高血圧症	高ＩｇＧ血症,高ＩｇＧ４血症	高ＩｇＧ血症,ＩｇＧ４関連疾患,高ＩｇＧ血症
高血糖	耐糖能異常,食後高血糖,耐糖能障害	耐糖能異常,高血糖症
高ＣＫ血症	高ＣＫ血症	高クレアチンキナーゼ血症
高ＩｇＥ症候群	高ＩｇＥ血症	高ＩｇＥ血症
鬱血痕	点状出血	点状出血
鮮血	活動性出血	出血
鱗屑	落屑	鱗屑
鳴き声	喘鳴	喘鳴
麻痺	しびれ,痺れ,しびれ感,痺れ感,感覚障害,痙攣,四肢脱力感,感覚異常,固縮,呼吸筋麻痺,痙攣重積状態,けいれん,温痛覚障害	しびれ感,体感異常,痙攣,四肢脱力感,感覚異常症,こわばり,呼吸麻痺,痙攣重積発作,温痛覚過敏
麻痺する	しびれ	しびれ感
麻痺感	しびれ感	しびれ感
黄いろくみえる	黄疸	黄疸
黄ばむ	黄疸	黄疸
黄ばむこと	黄染	黄疸
黄疸	高ビリルビン血症,黄染,皮膚黄染,チアノーゼ	高ビリルビン血症,黄疸,チアノーゼ
黄色	黄疸	黄疸
黄色い	黄疸	黄疸
黄色い斑点	黄疸	黄疸
黄色い痰	膿性痰	膿性痰
黄色い肌	黄疸	黄疸
黄色い跡	黄疸	黄疸
黄色くなる	黄疸,黄染	黄疸
黄色く染まる	黄染	黄疸
黄色く粘りのある痰	膿性痰	膿性痰
黄色く見える	黄疸	黄疸
黄色斑点	黄疸	黄疸
黒いうんこ	黒色便,タール便	黒色便
黒いうんち	黒色便,タール便	黒色便
黒いねっとりとした便	タール便	黒色便
黒いねっとりとした悪臭を放つ黒色便	タール便	黒色便
黒いべん	黒色便	黒色便
黒いウンコ	黒色便	黒色便
黒いウンチ	黒色便	黒色便
黒い便	黒色便,タール便	黒色便
黒い便が出る	黒色便	黒色便
黒い大便	黒色便	黒色便
黒い血便	タール便	黒色便
黒くドロッとした大便	タール便	黒色便
黒っぽいタールのような便	タール便	黒色便
黒っぽい便	黒色便	黒色便
黒便	黒色便	黒色便
黒色の大便	黒色便	黒色便
黒色便	タール便,黒色便	黒色便
黒血	皮下出血	皮下出血
鼓動	動悸	動悸
鼓動が早い	動悸	動悸
鼓動が早くなること	動悸	動悸
鼓動が激しい	動悸	動悸
鼓動恩	心雑音	心雑音
鼠径ヘルニア	頚部リンパ節腫脹	頚部リンパ節腫脹
鼻から血が出る	鼻出血	鼻出血症,鼻血
鼻の中や喉が赤くなる	粘膜発赤	発赤
鼻出血	鼻出血	鼻出血症,鼻血
鼻血	鼻出血,嚢胞内出血	鼻出血症,鼻血,内出血
鼻血がでる	鼻出血	鼻出血症,鼻血
鼻血が出る	鼻出血	鼻出血症,鼻血
ＡＬＳ	四肢筋力低下	四肢筋力低下
ＣＥＡ値がたかい	ＣＥＡ高値	ＣＥＡ高値
ＣＰＫが高い	高ＣＰＫ血症	高クレアチンキナーゼ血症
ＣＰＫ血症がたかい	高ＣＰＫ血症	高クレアチンキナーゼ血症
ＬＤＨが高い	高LDH血症	
ＬＤＨ血症がたかい	高LDH血症	
Ｘ線撮影像で肺に影があること	肺陰影	胸部異常陰影